date,original_tripc,original_male,original_female,filtered_tripc,filtered_male,filtered_female
01/06/2013,8722,3917,1215,5132,3917,1215
02/06/2013,15971,3954,1276,5230,3954,1276
03/06/2013,7598,3717,893,4610,3717,893
04/06/2013,15782,7013,1796,8809,7013,1796
05/06/2013,15690,6836,1783,8619,6836,1783
06/06/2013,12420,5493,1403,6896,5493,1403
07/06/2013,1226,768,123,891,768,123
08/06/2013,18007,4987,1524,6511,4987,1524
09/06/2013,21034,4640,1532,6172,4640,1532
10/06/2013,3897,2159,445,2604,2159,445
11/06/2013,12596,6529,1642,8171,6529,1642
12/06/2013,16795,7744,2096,9840,7744,2096
13/06/2013,8016,4443,986,5429,4443,986
14/06/2013,14942,7124,1806,8930,7124,1806
15/06/2013,25178,6417,2158,8575,6417,2158
16/06/2013,21966,6065,1926,7991,6065,1926
17/06/2013,19659,9169,2489,11658,9169,2489
18/06/2013,13724,7072,1673,8745,7072,1673
19/06/2013,24142,12141,3195,15336,12141,3195
20/06/2013,26603,13978,3539,17517,13978,3539
21/06/2013,27997,14194,3644,17838,14194,3644
22/06/2013,29281,9976,3299,13275,9976,3299
23/06/2013,28065,10154,3345,13499,10154,3345
24/06/2013,24251,13921,3673,17594,13921,3673
25/06/2013,27827,16717,4417,21134,16717,4417
26/06/2013,29499,17902,4871,22773,17902,4871
27/06/2013,24334,15341,3998,19339,15341,3998
28/06/2013,27818,17122,4550,21672,17122,4550
29/06/2013,29753,13122,4396,17518,13122,4396
30/06/2013,24909,10877,3770,14647,10877,3770
01/07/2013,16650,11095,2821,13916,11095,2821
02/07/2013,22745,14645,4029,18672,14643,4029
03/07/2013,21864,13967,3746,17710,13964,3746
04/07/2013,22326,8419,3135,11553,8418,3135
05/07/2013,21842,10431,3234,13665,10431,3234
06/07/2013,20467,8560,2943,11503,8560,2943
07/07/2013,20477,9411,3200,12610,9410,3200
08/07/2013,21615,13663,3834,17497,13663,3834
09/07/2013,26641,17471,4881,22352,17471,4881
10/07/2013,25732,16880,4831,21707,16876,4831
11/07/2013,24417,16072,4656,20728,16072,4656
12/07/2013,19006,12980,3265,16245,12980,3265
13/07/2013,26119,13231,5009,18240,13231,5009
14/07/2013,29287,14083,5341,19424,14083,5341
15/07/2013,28069,18418,5359,23777,18418,5359
16/07/2013,29842,19989,5892,25881,19989,5892
17/07/2013,30550,20361,6062,26423,20361,6062
18/07/2013,28869,19542,5747,25289,19542,5747
19/07/2013,26591,17800,5037,22837,17800,5037
20/07/2013,25278,12959,4747,17706,12959,4747
21/07/2013,30297,14862,5705,20565,14860,5705
22/07/2013,25979,17345,5075,22420,17345,5075
23/07/2013,32376,21881,6501,28382,21881,6501
24/07/2013,35271,23414,7140,30554,23414,7140
25/07/2013,31084,21471,5956,27427,21471,5956
26/07/2013,34534,22422,6620,29042,22422,6620
27/07/2013,32470,15493,6004,21497,15493,6004
28/07/2013,23508,12117,4519,16627,12108,4519
29/07/2013,34915,22761,6917,29676,22759,6917
30/07/2013,37334,24775,7463,32238,24775,7463
31/07/2013,37261,24961,7337,32296,24960,7336
01/08/2013,20138,14789,3757,18546,14789,3757
02/08/2013,35792,23092,6926,30018,23092,6926
03/08/2013,29540,14890,5621,20503,14882,5621
04/08/2013,35253,16341,6669,23010,16341,6669
05/08/2013,36776,23430,7238,30668,23430,7238
06/08/2013,37702,24644,7688,32332,24644,7688
07/08/2013,34396,23239,6934,30173,23239,6934
08/08/2013,28366,19609,5527,25136,19609,5527
09/08/2013,29017,19587,5718,25305,19587,5718
10/08/2013,37201,16699,6854,23553,16699,6854
11/08/2013,33060,15602,6217,21819,15602,6217
12/08/2013,31457,20809,6191,27000,20809,6191
13/08/2013,22437,15680,4369,20049,15680,4369
14/08/2013,38150,25489,7709,33198,25489,7709
15/08/2013,37386,25071,7400,32470,25070,7400
16/08/2013,35991,23273,7231,30504,23273,7231
17/08/2013,37285,16792,6946,23738,16792,6946
18/08/2013,27612,14339,5602,19941,14339,5602
19/08/2013,33127,22044,6528,28572,22044,6528
20/08/2013,35843,24056,7367,31423,24056,7367
21/08/2013,36315,24761,7444,32204,24760,7444
22/08/2013,26629,18866,5384,24250,18866,5384
23/08/2013,33503,21771,6751,28522,21771,6751
24/08/2013,32941,16610,6495,23104,16609,6495
25/08/2013,31755,15653,6513,22165,15652,6513
26/08/2013,29979,20234,6218,26452,20234,6218
27/08/2013,34208,23272,7276,30548,23272,7276
28/08/2013,28185,19704,5951,25655,19704,5951
29/08/2013,34215,23185,7068,30253,23185,7068
30/08/2013,32318,21036,6473,27509,21036,6473
31/08/2013,25381,12347,4883,17230,12347,4883
01/09/2013,25235,11439,4584,16023,11439,4584
02/09/2013,21416,11348,4371,15719,11348,4371
03/09/2013,32411,22337,6751,29088,22337,6751
04/09/2013,36798,25167,7739,32906,25167,7739
05/09/2013,35825,24365,7350,31715,24365,7350
06/09/2013,35868,24271,7261,31532,24271,7261
07/09/2013,34419,18223,7318,25541,18223,7318
08/09/2013,33196,17944,7195,25139,17944,7195
09/09/2013,35394,24458,7394,31852,24458,7394
10/09/2013,36954,25691,7951,33642,25691,7951
11/09/2013,35812,24753,7713,32466,24753,7713
12/09/2013,31252,22224,6437,28661,22224,6437
13/09/2013,36501,25427,7405,32832,25427,7405
14/09/2013,31607,16926,6878,23802,16924,6878
15/09/2013,31914,17138,7172,24310,17138,7172
16/09/2013,31287,22147,6519,28666,22147,6519
17/09/2013,38283,26995,8142,35137,26995,8142
18/09/2013,37957,26621,8085,34706,26621,8085
19/09/2013,39200,27107,8432,35539,27107,8432
20/09/2013,39382,26776,8272,35048,26776,8272
21/09/2013,31826,17563,6884,24447,17563,6884
22/09/2013,29758,16494,6773,23267,16494,6773
23/09/2013,35152,24508,7458,31966,24508,7458
24/09/2013,38417,27024,8104,35128,27024,8104
25/09/2013,38223,26810,8310,35120,26810,8310
26/09/2013,38189,26968,8171,35139,26968,8171
27/09/2013,37412,25939,7803,33742,25939,7803
28/09/2013,34931,19106,7736,26842,19106,7736
29/09/2013,32592,18081,7271,25352,18081,7271
30/09/2013,37148,25882,7921,33803,25882,7921
01/10/2013,40575,28517,8822,37339,28517,8822
02/10/2013,41383,28965,9020,37985,28965,9020
03/10/2013,40456,28281,8699,36980,28281,8699
04/10/2013,40195,27590,8595,36185,27590,8595
05/10/2013,34181,19052,7534,26586,19052,7534
06/10/2013,26574,16052,6188,22240,16052,6188
07/10/2013,25016,18345,5241,23586,18345,5241
08/10/2013,38365,27202,8295,35497,27202,8295
09/10/2013,36969,26668,8002,34670,26668,8002
10/10/2013,31171,23151,6328,29479,23151,6328
11/10/2013,33357,24136,6963,31099,24136,6963
12/10/2013,32457,18520,7307,25827,18520,7307
13/10/2013,28832,16528,6483,23011,16528,6483
14/10/2013,33018,22338,7070,29408,22338,7070
15/10/2013,37534,26706,8193,34899,26706,8193
16/10/2013,36911,26381,8065,34446,26381,8065
17/10/2013,36888,26603,7878,34481,26603,7878
18/10/2013,38122,26699,8017,34716,26699,8017
19/10/2013,29548,17445,6714,24158,17444,6714
20/10/2013,29256,16855,6791,23646,16855,6791
21/10/2013,35012,24596,7608,32204,24596,7608
22/10/2013,36338,26172,7855,34027,26172,7855
23/10/2013,32365,24068,6920,30988,24068,6920
24/10/2013,32251,23875,6892,30767,23875,6892
25/10/2013,30979,22707,6484,29191,22707,6484
26/10/2013,24569,15629,5692,21321,15629,5692
27/10/2013,23965,14766,5714,20480,14766,5714
28/10/2013,31498,22821,6899,29720,22821,6899
29/10/2013,33414,24458,7303,31761,24458,7303
30/10/2013,35069,25892,7704,33596,25892,7704
31/10/2013,31444,23275,6645,29920,23275,6645
01/11/2013,30384,22031,6169,28200,22031,6169
02/11/2013,31013,17890,7052,24942,17890,7052
03/11/2013,20798,13507,4834,18341,13507,4834
04/11/2013,27142,19871,5692,25563,19871,5692
05/11/2013,31493,23182,6672,29854,23182,6672
06/11/2013,34826,25386,7488,32874,25386,7488
07/11/2013,25719,19805,5187,24992,19805,5187
08/11/2013,28686,21364,5963,27327,21364,5963
09/11/2013,21734,14085,5060,19145,14085,5060
10/11/2013,19712,12738,4530,17268,12738,4530
11/11/2013,27295,20156,5675,25831,20156,5675
12/11/2013,19925,15539,3907,19446,15539,3907
13/11/2013,23633,18149,4960,23109,18149,4960
14/11/2013,27040,20527,5772,26299,20527,5772
15/11/2013,29051,21543,6068,27611,21543,6068
16/11/2013,25194,15413,5791,21203,15412,5791
17/11/2013,17995,11982,4008,15990,11982,4008
18/11/2013,30615,22422,6743,29165,22422,6743
19/11/2013,27417,20812,5826,26638,20812,5826
20/11/2013,26229,19982,5560,25542,19982,5560
21/11/2013,28752,21791,6020,27811,21791,6020
22/11/2013,25448,19333,5204,24537,19333,5204
23/11/2013,18996,12658,4471,17129,12658,4471
24/11/2013,9392,6864,2144,9008,6864,2144
25/11/2013,19116,14856,3881,18737,14856,3881
26/11/2013,14999,11691,3000,14691,11691,3000
27/11/2013,7976,6390,1430,7820,6390,1430
28/11/2013,5204,3509,1137,4646,3509,1137
29/11/2013,10127,7275,1943,9218,7275,1943
30/11/2013,9863,6635,2184,8819,6635,2184
01/12/2013,13326,9097,3102,12199,9097,3102
02/12/2013,24576,18745,5147,23892,18745,5147
03/12/2013,27431,20832,5923,26755,20832,5923
04/12/2013,28199,21374,6045,27419,21374,6045
05/12/2013,26988,20517,5612,26129,20517,5612
06/12/2013,10736,8519,1984,10503,8519,1984
07/12/2013,15545,10829,3661,14490,10829,3661
08/12/2013,10090,7261,2369,9630,7261,2369
09/12/2013,14824,11685,2862,14547,11685,2862
10/12/2013,12850,10416,2259,12675,10416,2259
11/12/2013,18766,14776,3703,18479,14776,3703
12/12/2013,17214,13659,3323,16982,13659,3323
13/12/2013,17888,14055,3439,17494,14055,3439
14/12/2013,3701,2943,652,3595,2943,652
15/12/2013,7462,5660,1629,7288,5659,1629
16/12/2013,15562,12485,2843,15328,12485,2843
17/12/2013,7863,6501,1281,7782,6501,1281
18/12/2013,14924,12061,2626,14687,12061,2626
19/12/2013,18766,14888,3518,18406,14888,3518
20/12/2013,22066,17138,4100,21238,17138,4100
21/12/2013,17940,11826,3966,15792,11826,3966
22/12/2013,15063,9974,3269,13243,9974,3269
23/12/2013,6956,5527,1184,6711,5527,1184
24/12/2013,11025,8352,2191,10543,8352,2191
25/12/2013,3260,2217,623,2840,2217,623
26/12/2013,9763,7494,1853,9347,7494,1853
27/12/2013,11720,8757,2188,10945,8757,2188
28/12/2013,12022,7489,2419,9908,7489,2419
29/12/2013,3775,2785,711,3496,2785,711
30/12/2013,13241,9903,2459,12362,9903,2459
31/12/2013,10424,7822,2044,9866,7822,2044
01/01/2014,6059,4217,1190,5407,4217,1190
02/01/2014,8600,6906,1513,8419,6906,1513
03/01/2014,1144,986,137,1123,986,137
04/01/2014,2292,1820,443,2263,1820,443
05/01/2014,2678,2198,445,2643,2198,445
06/01/2014,9510,7774,1634,9408,7774,1634
07/01/2014,6267,5288,951,6239,5288,951
08/01/2014,9246,7589,1600,9189,7589,1600
09/01/2014,13354,10763,2428,13191,10763,2428
10/01/2014,9847,8039,1679,9718,8039,1679
11/01/2014,7695,5863,1638,7501,5863,1638
12/01/2014,12515,8768,2970,11738,8768,2970
13/01/2014,20633,15957,4088,20045,15957,4088
14/01/2014,9999,8068,1774,9842,8068,1774
15/01/2014,21630,16720,4324,21044,16720,4324
16/01/2014,19953,15615,3866,19481,15615,3866
17/01/2014,20301,15495,4023,19518,15495,4023
18/01/2014,9438,6955,2005,8960,6955,2005
19/01/2014,9028,6392,2184,8576,6392,2184
20/01/2014,13407,9968,2923,12891,9968,2923
21/01/2014,3804,3191,588,3779,3191,588
22/01/2014,2451,2087,336,2423,2087,336
23/01/2014,5071,4226,810,5036,4226,810
24/01/2014,6176,5190,941,6131,5190,941
25/01/2014,4338,3469,796,4265,3469,796
26/01/2014,4980,3874,1018,4892,3874,1018
27/01/2014,13119,10567,2433,13000,10567,2433
28/01/2014,10033,8222,1761,9983,8222,1761
29/01/2014,10021,8229,1737,9966,8229,1737
30/01/2014,12158,9887,2157,12044,9887,2157
31/01/2014,14653,11783,2633,14416,11783,2633
01/02/2014,12771,9078,2949,12027,9078,2949
02/02/2014,13816,9451,3386,12837,9451,3386
03/02/2014,2600,2215,363,2578,2215,363
04/02/2014,8709,7074,1550,8624,7074,1550
05/02/2014,2746,2321,399,2720,2321,399
06/02/2014,7196,5977,1146,7123,5977,1146
07/02/2014,8495,7025,1402,8427,7025,1402
08/02/2014,5986,4646,1224,5870,4646,1224
09/02/2014,4996,3827,1075,4902,3827,1075
10/02/2014,6846,5688,1116,6804,5688,1116
11/02/2014,8343,6880,1418,8298,6880,1418
12/02/2014,8580,7071,1459,8530,7071,1459
13/02/2014,876,778,95,873,778,95
14/02/2014,3609,3055,520,3575,3055,520
15/02/2014,2261,1786,427,2213,1786,427
16/02/2014,3003,2359,557,2916,2359,557
17/02/2014,4854,3878,875,4753,3878,875
18/02/2014,5140,4321,769,5090,4321,769
19/02/2014,8506,6990,1437,8427,6990,1437
20/02/2014,11792,9586,2014,11600,9586,2014
21/02/2014,8680,7114,1436,8550,7114,1436
22/02/2014,13044,8771,2865,11636,8771,2865
23/02/2014,13324,8802,3080,11882,8802,3080
24/02/2014,12922,10395,2301,12696,10395,2301
25/02/2014,12830,10385,2247,12632,10385,2247
26/02/2014,11188,9265,1802,11067,9265,1802
27/02/2014,12036,9910,1983,11893,9910,1983
28/02/2014,9587,7878,1584,9462,7878,1584
01/03/2014,9202,6655,1959,8614,6655,1959
02/03/2014,8195,5996,1760,7756,5996,1760
03/03/2014,7708,6316,1267,7583,6316,1267
04/03/2014,10398,8535,1735,10270,8535,1735
05/03/2014,13801,11176,2405,13581,11176,2405
06/03/2014,12773,10340,2257,12597,10340,2257
07/03/2014,13304,10745,2306,13051,10745,2306
08/03/2014,16350,10393,3586,13979,10393,3586
09/03/2014,12262,8257,2802,11059,8257,2802
10/03/2014,17231,13407,3277,16684,13407,3277
11/03/2014,24356,17985,4993,22978,17985,4993
12/03/2014,15101,11627,2991,14618,11627,2991
13/03/2014,10979,8906,1862,10768,8906,1862
14/03/2014,16299,12654,3042,15696,12654,3042
15/03/2014,18053,11412,4007,15418,11411,4007
16/03/2014,9851,6945,2182,9127,6945,2182
17/03/2014,12503,9957,2224,12181,9957,2224
18/03/2014,16679,13070,3065,16135,13070,3065
19/03/2014,13341,10546,2513,13059,10546,2513
20/03/2014,19695,15097,3855,18952,15097,3855
21/03/2014,20718,15718,4025,19743,15718,4025
22/03/2014,19880,12086,4415,16501,12086,4415
23/03/2014,11740,7889,2578,10467,7889,2578
24/03/2014,13598,10694,2554,13248,10694,2554
25/03/2014,16037,12674,2988,15662,12674,2988
26/03/2014,14500,11713,2542,14255,11713,2542
27/03/2014,16666,13125,3109,16234,13125,3109
28/03/2014,18425,14386,3428,17814,14386,3428
29/03/2014,4480,3366,867,4233,3366,867
30/03/2014,7907,5722,1720,7442,5722,1720
31/03/2014,17085,13176,3310,16486,13176,3310
01/04/2014,23908,17967,4800,22767,17967,4800
02/04/2014,22515,17454,4412,21866,17454,4412
03/04/2014,26321,19791,5162,24953,19791,5162
04/04/2014,12566,10044,2193,12237,10044,2193
05/04/2014,18655,12141,4027,16168,12141,4027
06/04/2014,20750,12524,4626,17150,12524,4626
07/04/2014,14677,11219,2851,14070,11219,2851
08/04/2014,21884,16662,4424,21086,16662,4424
09/04/2014,26931,20349,5405,25754,20349,5405
10/04/2014,27463,20578,5476,26054,20578,5476
11/04/2014,26798,19986,5335,25321,19986,5335
12/04/2014,27108,15728,5751,21479,15728,5751
13/04/2014,26871,15368,5966,21334,15368,5966
14/04/2014,28832,20274,5757,26031,20274,5757
15/04/2014,10523,8309,1846,10155,8309,1846
16/04/2014,20082,15249,3844,19093,15249,3844
17/04/2014,22282,16818,4123,20941,16818,4123
18/04/2014,20770,15070,3953,19023,15070,3953
19/04/2014,24369,13468,4898,18366,13468,4898
20/04/2014,18464,10551,3703,14254,10551,3703
21/04/2014,27124,19351,5358,24709,19351,5358
22/04/2014,27259,20024,5435,25459,20024,5435
23/04/2014,26949,20200,5376,25576,20200,5376
24/04/2014,28107,20762,5618,26380,20762,5618
25/04/2014,27919,20440,5378,25818,20440,5378
26/04/2014,19899,12082,4354,16436,12082,4354
27/04/2014,21926,13241,4823,18064,13241,4823
28/04/2014,28557,20918,5612,26530,20918,5612
29/04/2014,18404,14434,3343,17777,14434,3343
30/04/2014,2867,2393,424,2817,2393,424
01/05/2014,26762,19763,5305,25068,19763,5305
02/05/2014,32377,23069,6249,29318,23069,6249
03/05/2014,25501,14891,5257,20147,14890,5257
04/05/2014,21277,12922,4557,17479,12922,4557
05/05/2014,30288,21523,6202,27725,21523,6202
06/05/2014,32233,23405,6484,29889,23405,6484
07/05/2014,32882,23651,6637,30288,23651,6637
08/05/2014,17619,13368,3192,16560,13368,3192
09/05/2014,22641,16911,4096,21007,16911,4096
10/05/2014,21832,13427,4697,18124,13427,4697
11/05/2014,28326,15689,6025,21714,15689,6025
12/05/2014,31644,22331,6632,28963,22331,6632
13/05/2014,32847,23905,6644,30549,23905,6644
14/05/2014,30044,22120,6128,28248,22120,6128
15/05/2014,26057,19282,5268,24550,19282,5268
16/05/2014,17784,13569,3402,16971,13569,3402
17/05/2014,29912,16823,6308,23131,16823,6308
18/05/2014,27436,15291,5871,21162,15291,5871
19/05/2014,31692,22511,6406,28917,22511,6406
20/05/2014,35567,25124,7392,32516,25124,7392
21/05/2014,34420,24666,7046,31712,24666,7046
22/05/2014,24535,18377,4583,22960,18377,4583
23/05/2014,24484,17492,4835,22327,17492,4835
24/05/2014,16798,9575,3481,13054,9575,3479
25/05/2014,25637,11927,4786,16713,11927,4786
26/05/2014,26930,13449,5194,18643,13449,5194
27/05/2014,32936,22858,6581,29439,22858,6581
28/05/2014,29690,21932,5780,27712,21932,5780
29/05/2014,33889,24084,6901,30985,24084,6901
30/05/2014,34343,23966,6999,30965,23966,6999
31/05/2014,27734,15795,5872,21664,15792,5872
01/06/2014,31333,17218,6823,24041,17218,6823
02/06/2014,34519,24101,7021,31122,24101,7021
03/06/2014,29501,21253,5990,27243,21253,5990
04/06/2014,36068,25525,7614,33139,25525,7614
05/06/2014,24619,17501,5126,22627,17501,5126
06/06/2014,37719,25806,7568,33374,25806,7568
07/06/2014,31204,17334,6549,23880,17334,6546
08/06/2014,30162,16827,6433,23260,16827,6433
09/06/2014,18611,13565,3620,17185,13565,3620
10/06/2014,33435,23930,7102,31032,23930,7102
11/06/2014,30548,22019,6419,28438,22019,6419
12/06/2014,29084,21170,6042,27212,21170,6042
13/06/2014,18308,13369,3609,16978,13369,3609
14/06/2014,28417,16166,6288,22453,16166,6287
15/06/2014,28382,15943,6161,22104,15943,6161
16/06/2014,34932,24073,7543,31616,24073,7543
17/06/2014,35097,24728,7566,32294,24728,7566
18/06/2014,35531,24958,7793,32751,24958,7793
19/06/2014,31724,22708,6690,29398,22708,6690
20/06/2014,34405,23591,7181,30771,23591,7180
21/06/2014,30288,16624,6473,23097,16624,6473
22/06/2014,29417,16339,6271,22610,16339,6271
23/06/2014,32580,22669,6885,29553,22668,6885
24/06/2014,35897,25408,7761,33168,25407,7761
25/06/2014,34340,24404,7282,31686,24404,7282
26/06/2014,34846,24590,7277,31864,24587,7277
27/06/2014,35823,24379,7246,31623,24377,7246
28/06/2014,28507,15919,6016,21934,15919,6015
29/06/2014,27986,15462,6171,21631,15462,6169
30/06/2014,33597,23370,7059,30428,23369,7059
01/07/2014,34854,24736,7435,32169,24734,7435
02/07/2014,26582,19085,5401,24486,19085,5401
03/07/2014,27587,19441,5694,25134,19440,5694
04/07/2014,13612,8034,2796,10830,8034,2796
05/07/2014,22913,11148,4423,15571,11148,4423
06/07/2014,23822,12398,4844,17242,12398,4844
07/07/2014,31863,22150,6828,28977,22149,6828
08/07/2014,32713,23357,7134,30489,23355,7134
09/07/2014,34426,24381,7405,31784,24379,7405
10/07/2014,36288,25588,7680,33266,25586,7680
11/07/2014,35000,24186,7063,31247,24184,7063
12/07/2014,28718,15874,6174,22048,15874,6174
13/07/2014,24869,14614,5350,19964,14614,5350
14/07/2014,25825,18487,5099,23584,18485,5099
15/07/2014,22963,16970,4577,21544,16967,4577
16/07/2014,35391,25288,7417,32699,25282,7417
17/07/2014,38619,27297,8075,35371,27296,8075
18/07/2014,36105,24669,7563,32229,24667,7562
19/07/2014,29291,15584,6124,21707,15584,6123
20/07/2014,30296,16425,6359,22783,16425,6358
21/07/2014,35670,24771,7479,32249,24770,7479
22/07/2014,36886,25944,7933,33876,25943,7933
23/07/2014,34173,24381,7195,31576,24381,7195
24/07/2014,36693,26138,7472,33610,26138,7472
25/07/2014,36384,25055,7337,32392,25055,7337
26/07/2014,27179,15098,5524,20622,15098,5524
27/07/2014,27004,15270,5954,21224,15270,5954
28/07/2014,33189,23316,6987,30303,23316,6987
29/07/2014,37092,26180,7813,33993,26180,7813
30/07/2014,37377,26349,7734,34083,26349,7734
31/07/2014,35458,25252,7267,32519,25252,7267
01/08/2014,32654,22757,6549,29306,22757,6549
02/08/2014,26784,14849,5649,20498,14849,5649
03/08/2014,25276,14250,5255,19505,14250,5255
04/08/2014,33822,23257,6951,30208,23257,6951
05/08/2014,34392,24117,7164,31281,24117,7164
06/08/2014,36336,25512,7663,33175,25512,7663
07/08/2014,36362,25545,7544,33089,25545,7544
08/08/2014,34073,23323,7016,30339,23323,7016
09/08/2014,31636,15619,6381,22000,15619,6381
10/08/2014,26749,14755,5655,20410,14755,5655
11/08/2014,33664,23143,6842,29985,23143,6842
12/08/2014,26261,19139,5062,24201,19139,5062
13/08/2014,27977,20127,5745,25872,20127,5745
14/08/2014,35154,24660,7185,31845,24660,7185
15/08/2014,32480,22372,6588,28960,22372,6588
16/08/2014,32017,15759,6281,22040,15759,6281
17/08/2014,27417,15161,5661,20822,15161,5661
18/08/2014,34339,23437,7053,30490,23437,7053
19/08/2014,35367,24938,7432,32370,24938,7432
20/08/2014,35532,24811,7247,32058,24811,7247
21/08/2014,33804,23827,6824,30651,23827,6824
22/08/2014,30406,21389,6156,27545,21389,6156
23/08/2014,26429,14675,5509,20184,14675,5509
24/08/2014,27493,14798,5714,20512,14798,5714
25/08/2014,32892,22845,6771,29612,22845,6767
26/08/2014,34519,24402,7099,31496,24402,7094
27/08/2014,33721,24122,7000,31122,24122,7000
28/08/2014,33927,24349,6731,31080,24349,6731
29/08/2014,31264,21361,6132,27493,21361,6132
30/08/2014,22689,11952,4359,16311,11952,4359
31/08/2014,18053,9405,3501,12906,9405,3501
01/09/2014,23575,12821,5004,17825,12821,5004
02/09/2014,30507,21761,6333,28094,21761,6333
03/09/2014,35535,25568,7500,33068,25568,7500
04/09/2014,36496,26040,7716,33755,26039,7716
05/09/2014,34831,24416,7182,31598,24416,7182
06/09/2014,25833,15659,5694,21353,15659,5694
07/09/2014,29721,17106,6651,23757,17106,6651
08/09/2014,34335,24403,7276,31679,24403,7276
09/09/2014,34518,25110,7246,32356,25110,7246
10/09/2014,37653,26938,7874,34812,26938,7874
11/09/2014,37081,26623,7814,34437,26623,7814
12/09/2014,37204,26194,7818,34012,26194,7818
13/09/2014,17293,11303,3952,15255,11303,3952
14/09/2014,28688,16601,6429,23030,16601,6429
15/09/2014,35045,24790,7468,32258,24790,7468
16/09/2014,25633,18864,5320,24184,18864,5320
17/09/2014,37453,26598,8080,34678,26598,8080
18/09/2014,37381,26616,8054,34670,26616,8054
19/09/2014,34713,24905,7122,32025,24903,7122
20/09/2014,30011,17298,6526,23824,17298,6526
21/09/2014,26080,15558,5931,21489,15558,5931
22/09/2014,33239,23815,6993,30808,23815,6993
23/09/2014,36347,26084,7733,33814,26081,7733
24/09/2014,35481,25796,7441,33237,25796,7441
25/09/2014,16650,12884,3090,15974,12884,3090
26/09/2014,35116,24460,7201,31661,24460,7201
27/09/2014,30193,17366,6650,24016,17366,6650
28/09/2014,29021,16537,6447,22984,16537,6447
29/09/2014,33161,23724,6937,30661,23724,6937
30/09/2014,35093,25655,7374,33029,25655,7374
01/10/2014,27942,20948,5794,26742,20948,5794
02/10/2014,34492,25286,7199,32485,25286,7199
03/10/2014,34944,24336,7169,31505,24336,7169
04/10/2014,13354,9099,2801,11899,9098,2801
05/10/2014,23456,14346,5328,19674,14346,5328
06/10/2014,31742,22862,6577,29439,22862,6577
07/10/2014,32892,24038,7137,31175,24038,7137
08/10/2014,33607,24495,7144,31639,24495,7144
09/10/2014,32203,23467,6585,30052,23467,6585
10/10/2014,30887,22284,6259,28543,22284,6259
11/10/2014,12965,8910,2583,11493,8910,2583
12/10/2014,23394,13420,4926,18346,13420,4926
13/10/2014,22752,15828,4642,20470,15828,4642
14/10/2014,32614,23451,6831,30281,23450,6831
15/10/2014,28743,21216,6012,27228,21216,6012
16/10/2014,26754,19853,5565,25418,19853,5565
17/10/2014,34132,24000,6871,30871,24000,6871
18/10/2014,24978,15094,5339,20433,15094,5339
19/10/2014,18840,12099,4214,16313,12099,4214
20/10/2014,27914,20527,5684,26211,20527,5684
21/10/2014,31330,23065,6566,29631,23065,6566
22/10/2014,9169,7151,1626,8777,7151,1626
23/10/2014,13371,10644,2409,13053,10644,2409
24/10/2014,29837,21912,5973,27885,21912,5973
25/10/2014,24952,14930,5339,20269,14930,5339
26/10/2014,20768,12763,4673,17436,12763,4673
27/10/2014,28806,21162,5945,27107,21162,5945
28/10/2014,32956,24159,6930,31089,24159,6930
29/10/2014,29999,22223,6253,28476,22223,6253
30/10/2014,31133,23239,6310,29549,23239,6310
31/10/2014,27785,20432,5427,25859,20432,5427
01/11/2014,6002,4587,1101,5688,4587,1101
02/11/2014,14100,9765,3181,12946,9765,3181
03/11/2014,26757,19727,5495,25222,19727,5495
04/11/2014,31174,23067,6334,29401,23067,6334
05/11/2014,30539,22642,6376,29018,22642,6376
06/11/2014,12283,9684,2290,11974,9684,2290
07/11/2014,25355,19064,5110,24174,19064,5110
08/11/2014,17443,11450,3933,15383,11450,3933
09/11/2014,18207,11755,4097,15852,11755,4097
10/11/2014,27655,20234,5659,25892,20233,5659
11/11/2014,29358,21735,5979,27714,21735,5979
12/11/2014,27807,20943,5869,26812,20943,5869
13/11/2014,20652,15622,4252,19874,15622,4252
14/11/2014,21082,16223,4216,20439,16223,4216
15/11/2014,14057,9775,3154,12929,9775,3154
16/11/2014,13272,9283,3110,12393,9283,3110
17/11/2014,8116,6479,1518,7997,6479,1518
18/11/2014,16691,13249,3181,16430,13249,3181
19/11/2014,16694,13232,3207,16439,13232,3207
20/11/2014,20611,16231,3969,20200,16231,3969
21/11/2014,17806,14038,3362,17400,14038,3362
22/11/2014,12682,9045,2885,11930,9045,2885
23/11/2014,15669,10765,3554,14319,10765,3554
24/11/2014,23031,17457,4643,22100,17457,4643
25/11/2014,25580,19384,5097,24481,19384,5097
26/11/2014,3675,3054,564,3618,3054,564
27/11/2014,3945,2873,848,3721,2873,848
28/11/2014,8378,6096,1697,7793,6096,1697
29/11/2014,8183,5797,1822,7619,5797,1822
30/11/2014,12384,8473,2782,11255,8473,2782
01/12/2014,18519,14178,3613,17791,14178,3613
02/12/2014,15367,12333,2837,15170,12333,2837
03/12/2014,13472,10819,2500,13319,10819,2500
04/12/2014,21335,16690,4158,20848,16690,4158
05/12/2014,15818,12314,3153,15467,12314,3153
06/12/2014,4047,3082,865,3947,3082,865
07/12/2014,10510,7580,2348,9928,7580,2348
08/12/2014,15557,12447,2901,15348,12447,2901
09/12/2014,6713,5558,1114,6672,5558,1114
10/12/2014,10399,8497,1819,10316,8497,1819
11/12/2014,18141,14478,3371,17849,14478,3371
12/12/2014,17892,14099,3401,17500,14099,3401
13/12/2014,12549,9020,2827,11847,9020,2827
14/12/2014,11941,8547,2732,11279,8547,2732
15/12/2014,19382,15139,3722,18861,15139,3722
16/12/2014,16816,13253,3205,16458,13253,3205
17/12/2014,20346,15880,3964,19844,15880,3964
18/12/2014,19051,15172,3512,18684,15172,3512
19/12/2014,17200,13560,3211,16771,13560,3211
20/12/2014,9582,7154,2055,9209,7154,2055
21/12/2014,8747,6419,1936,8355,6419,1936
22/12/2014,13560,10727,2416,13143,10727,2416
23/12/2014,9422,7557,1629,9186,7557,1629
24/12/2014,4285,3483,698,4181,3483,698
25/12/2014,4890,2798,862,3660,2798,862
26/12/2014,9895,6794,1801,8595,6794,1801
27/12/2014,10247,6195,2044,8239,6195,2044
28/12/2014,7902,5312,1628,6940,5312,1628
29/12/2014,13549,10102,2304,12406,10102,2304
30/12/2014,12196,9550,2005,11555,9550,2005
31/12/2014,9739,7402,1746,9148,7402,1746
01/01/2015,5317,3584,1067,4651,3584,1067
02/01/2015,11304,8488,2174,10662,8488,2174
03/01/2015,4478,3215,1037,4252,3215,1037
04/01/2015,7849,5734,1722,7456,5734,1722
05/01/2015,14506,11785,2471,14256,11785,2471
06/01/2015,8739,7354,1364,8718,7354,1364
07/01/2015,9646,8006,1604,9610,8006,1604
08/01/2015,8779,7282,1451,8733,7282,1451
09/01/2015,7930,6680,1211,7891,6680,1211
10/01/2015,6109,4766,1268,6034,4766,1268
11/01/2015,7467,5614,1681,7295,5614,1681
12/01/2015,8645,7147,1438,8585,7147,1438
13/01/2015,12797,10464,2259,12723,10464,2259
14/01/2015,13086,10624,2342,12966,10624,2342
15/01/2015,14075,11404,2487,13891,11404,2487
16/01/2015,13843,11153,2456,13609,11153,2456
17/01/2015,7491,5506,1668,7174,5506,1668
18/01/2015,1795,1439,329,1768,1439,329
19/01/2015,10710,8225,2177,10402,8225,2177
20/01/2015,16129,12986,2887,15873,12986,2887
21/01/2015,15234,12279,2785,15064,12279,2785
22/01/2015,15864,12763,2902,15665,12763,2902
23/01/2015,15737,12596,2831,15427,12596,2831
24/01/2015,4814,3796,906,4702,3796,906
25/01/2015,9379,6892,2058,8950,6892,2058
26/01/2015,4141,3489,628,4117,3489,628
27/01/2015,1214,1046,139,1185,1046,139
28/01/2015,5401,4590,778,5368,4590,778
29/01/2015,8870,7347,1430,8777,7347,1430
30/01/2015,9015,7421,1514,8935,7421,1514
31/01/2015,5188,4089,1029,5118,4089,1029
01/02/2015,6441,4897,1359,6256,4897,1359
02/02/2015,1459,1245,203,1448,1245,203
03/02/2015,4754,4092,653,4745,4092,653
04/02/2015,8973,7457,1476,8933,7457,1476
05/02/2015,9208,7752,1427,9179,7752,1427
06/02/2015,8575,7145,1381,8526,7145,1381
07/02/2015,6790,5217,1349,6566,5217,1349
08/02/2015,6662,5099,1371,6470,5099,1371
09/02/2015,5160,4311,798,5109,4311,798
10/02/2015,10328,8517,1718,10235,8517,1718
11/02/2015,11439,9377,1948,11325,9377,1948
12/02/2015,11269,9304,1853,11157,9304,1853
13/02/2015,7642,6337,1225,7562,6337,1225
14/02/2015,4614,3569,939,4508,3569,939
15/02/2015,2581,2059,489,2548,2059,489
16/02/2015,3998,3301,653,3954,3301,653
17/02/2015,4784,4047,706,4753,4047,706
18/02/2015,9170,7553,1537,9090,7553,1537
19/02/2015,7799,6557,1209,7766,6557,1209
20/02/2015,6159,5191,940,6131,5191,940
21/02/2015,3157,2465,645,3110,2465,645
22/02/2015,4274,3386,792,4178,3386,792
23/02/2015,7458,6280,1133,7413,6280,1133
24/02/2015,7402,6230,1123,7353,6230,1123
25/02/2015,10751,8841,1794,10635,8841,1794
26/02/2015,9901,8238,1592,9830,8238,1592
27/02/2015,9864,8152,1550,9702,8152,1550
28/02/2015,6318,4944,1201,6145,4944,1201
01/03/2015,2879,2162,599,2761,2162,599
02/03/2015,7283,6009,1180,7189,6009,1180
03/03/2015,6533,5470,1008,6478,5470,1008
04/03/2015,7514,6251,1208,7459,6251,1208
05/03/2015,1637,1432,201,1633,1432,201
06/03/2015,5162,4382,738,5120,4382,738
07/03/2015,5590,4255,1117,5372,4255,1117
08/03/2015,7898,5730,1720,7450,5730,1720
09/03/2015,14878,11667,2695,14362,11667,2695
10/03/2015,11781,9285,2179,11464,9285,2179
11/03/2015,19561,14975,3743,18718,14975,3743
12/03/2015,17530,13811,3154,16965,13811,3154
13/03/2015,16145,12366,3092,15458,12366,3092
14/03/2015,3906,3070,688,3758,3070,688
15/03/2015,8838,6455,1798,8253,6455,1798
16/03/2015,16787,12947,3114,16061,12947,3114
17/03/2015,14857,11696,2662,14358,11696,2662
18/03/2015,13842,11141,2399,13540,11141,2399
19/03/2015,15446,12229,2704,14933,12229,2704
20/03/2015,8052,6496,1384,7880,6496,1384
21/03/2015,9338,6591,1920,8511,6591,1920
22/03/2015,9676,6684,2060,8744,6684,2060
23/03/2015,13538,10688,2474,13162,10688,2474
24/03/2015,16166,12693,2917,15610,12693,2917
25/03/2015,14670,11571,2637,14208,11571,2637
26/03/2015,14954,11904,2708,14612,11904,2708
27/03/2015,14107,11036,2612,13648,11036,2612
28/03/2015,1107,897,199,1096,897,199
29/03/2015,9826,6816,2120,8936,6816,2120
30/03/2015,18075,13973,3383,17356,13973,3383
31/03/2015,14250,11167,2629,13796,11167,2629
01/04/2015,20146,15453,3791,19244,15453,3791
02/04/2015,24227,17574,4647,22221,17574,4647
03/04/2015,14774,10996,2846,13842,10996,2846
04/04/2015,14355,9054,2873,11927,9054,2873
05/04/2015,13799,8329,2667,10996,8329,2667
06/04/2015,23391,16761,4325,21086,16761,4325
07/04/2015,16262,12581,2980,15561,12581,2980
08/04/2015,17872,13966,3225,17191,13966,3225
09/04/2015,16546,13156,2936,16092,13156,2936
10/04/2015,16317,12547,3038,15585,12547,3038
11/04/2015,18643,11487,3874,15361,11487,3874
12/04/2015,19954,11554,4213,15767,11554,4213
13/04/2015,24925,18295,5109,23404,18295,5109
14/04/2015,22703,17261,4478,21739,17261,4478
15/04/2015,27594,20227,5603,25830,20227,5603
16/04/2015,27180,19887,5536,25423,19887,5536
17/04/2015,24175,17830,4761,22591,17830,4761
18/04/2015,28174,14831,5486,20317,14831,5486
19/04/2015,21475,12373,4483,16856,12373,4483
20/04/2015,11202,8729,2099,10828,8729,2099
21/04/2015,24868,18089,4935,23024,18089,4935
22/04/2015,21997,16355,4431,20786,16355,4431
23/04/2015,22074,16651,4356,21007,16651,4356
24/04/2015,20981,15834,3975,19809,15834,3975
25/04/2015,21082,12300,4216,16516,12300,4216
26/04/2015,21594,12379,4392,16771,12379,4392
27/04/2015,25501,18476,5046,23522,18476,5046
28/04/2015,29795,21311,5970,27281,21311,5970
29/04/2015,31532,22273,6308,28581,22273,6308
30/04/2015,29252,21026,5833,26859,21026,5833
01/05/2015,27924,19786,5399,25185,19786,5399
02/05/2015,25743,13885,5016,18901,13885,5016
03/05/2015,27694,14187,5321,19508,14187,5321
04/05/2015,32066,21425,6251,27676,21425,6251
05/05/2015,33012,23337,6534,29871,23337,6534
06/05/2015,30313,21604,6153,27757,21604,6153
07/05/2015,34871,24184,6833,31017,24184,6833
08/05/2015,34304,23132,6591,29723,23132,6591
09/05/2015,24329,13755,4830,18585,13755,4830
10/05/2015,26573,14178,5278,19456,14178,5278
11/05/2015,32382,22021,6314,28335,22021,6314
12/05/2015,35225,24149,6888,31037,24149,6888
13/05/2015,33402,23320,6490,29810,23320,6490
14/05/2015,40826,24405,6963,31368,24405,6963
15/05/2015,34945,23169,6602,29771,23169,6602
16/05/2015,23882,13192,4534,17726,13192,4534
17/05/2015,30969,15225,5866,21091,15225,5866
18/05/2015,31559,21626,6062,27688,21626,6062
19/05/2015,33895,23896,6692,30588,23896,6692
20/05/2015,33823,23835,6638,30473,23835,6638
21/05/2015,31214,22492,5968,28460,22492,5968
22/05/2015,31891,21336,6223,27559,21336,6223
23/05/2015,23910,11574,4356,15930,11574,4356
24/05/2015,25151,10635,4241,14876,10635,4241
25/05/2015,28164,12990,5068,18058,12990,5068
26/05/2015,35786,24073,7003,31076,24073,7003
27/05/2015,33710,23491,6761,30252,23491,6761
28/05/2015,35934,24755,7382,32137,24755,7382
29/05/2015,37756,25155,7562,32717,25155,7562
30/05/2015,31147,16266,6260,22526,16266,6260
31/05/2015,19586,10929,4034,14963,10929,4034
01/06/2015,15283,11640,2812,14452,11640,2812
02/06/2015,11984,9391,2113,11504,9391,2113
03/06/2015,34590,24362,6829,31191,24362,6829
04/06/2015,32772,23619,6453,30072,23619,6453
05/06/2015,31294,22178,6111,28289,22178,6111
06/06/2015,26334,14475,5223,19698,14475,5223
07/06/2015,30773,15570,6129,21699,15570,6129
08/06/2015,33585,22935,6838,29773,22935,6838
09/06/2015,35412,24874,7275,32149,24874,7275
10/06/2015,39350,27051,8125,35176,27051,8125
11/06/2015,37400,25790,7764,33554,25790,7764
12/06/2015,35136,23901,7027,30928,23901,7027
13/06/2015,29980,15695,5842,21537,15695,5842
14/06/2015,28184,14343,5640,19983,14343,5640
15/06/2015,25087,17786,4863,22649,17786,4863
16/06/2015,32147,22349,6450,28799,22349,6450
17/06/2015,38030,26345,7602,33947,26345,7602
18/06/2015,35464,25024,7185,32209,25024,7185
19/06/2015,37380,24982,7339,32321,24982,7339
20/06/2015,23580,13121,4703,17824,13121,4703
21/06/2015,25926,13785,5341,19126,13785,5341
22/06/2015,37677,25204,7658,32862,25204,7658
23/06/2015,32294,22503,6532,29035,22503,6532
24/06/2015,41070,28076,8572,36648,28076,8572
25/06/2015,39673,27417,7957,35374,27417,7957
26/06/2015,38614,26065,7641,33706,26065,7641
27/06/2015,15485,9069,3225,12294,9069,3225
28/06/2015,20591,11903,4505,16408,11903,4505
29/06/2015,38037,25653,7404,33057,25653,7404
30/06/2015,38087,26485,7497,33982,26485,7497
01/07/2015,37539,25823,7620,33443,25823,7620
02/07/2015,35559,23818,6905,30723,23818,6905
03/07/2015,26928,13249,5113,18362,13249,5113
04/07/2015,21706,8663,3519,12182,8663,3519
05/07/2015,25920,11778,4578,16356,11778,4578
06/07/2015,35251,23356,7069,30425,23356,7069
07/07/2015,36837,25221,7563,32784,25221,7563
08/07/2015,35047,24393,7193,31586,24393,7193
09/07/2015,31978,22398,6188,28586,22398,6188
10/07/2015,38559,25362,7697,33059,25362,7697
11/07/2015,31719,16217,6081,22298,16217,6081
12/07/2015,31037,15801,6257,22058,15801,6257
13/07/2015,38485,25797,7831,33628,25797,7831
14/07/2015,35802,24888,7654,32542,24888,7654
15/07/2015,34979,24714,7037,31751,24714,7037
16/07/2015,42356,28509,8516,37025,28509,8516
17/07/2015,39595,25733,8033,33766,25733,8033
18/07/2015,28870,15115,5662,20777,15115,5662
19/07/2015,28531,14566,5735,20301,14566,5735
20/07/2015,34889,23546,7138,30684,23546,7138
21/07/2015,38499,26151,7951,34102,26151,7951
22/07/2015,42557,28892,8824,37716,28892,8824
23/07/2015,42175,28483,8528,37011,28483,8528
24/07/2015,40330,26393,8069,34462,26393,8069
25/07/2015,31639,15401,6078,21479,15401,6078
26/07/2015,30543,15296,5960,21256,15296,5960
27/07/2015,38747,25914,7789,33703,25914,7789
28/07/2015,40434,27449,8220,35669,27449,8220
29/07/2015,39428,27074,8152,35226,27074,8152
30/07/2015,31166,21870,6326,28196,21870,6326
31/07/2015,38571,25385,7725,33110,25385,7725
01/08/2015,35179,16356,6416,22772,16356,6416
02/08/2015,31622,15509,6094,21603,15509,6094
03/08/2015,38888,25511,7964,33475,25511,7964
04/08/2015,40783,27211,8303,35514,27211,8303
05/08/2015,41075,27705,8470,36175,27705,8470
06/08/2015,42283,28072,8486,36558,28072,8486
07/08/2015,40999,26427,8069,34496,26427,8069
08/08/2015,38723,17113,6951,24064,17113,6951
09/08/2015,32716,15805,6095,21900,15805,6095
10/08/2015,39870,25931,7785,33716,25931,7785
11/08/2015,25066,17347,4981,22328,17347,4981
12/08/2015,42994,28785,8733,37518,28785,8733
13/08/2015,42170,28178,8465,36643,28178,8465
14/08/2015,39983,25798,8116,33914,25798,8116
15/08/2015,37821,16850,6975,23825,16850,6975
16/08/2015,30344,15224,5913,21137,15224,5913
17/08/2015,37449,24607,7604,32211,24607,7604
18/08/2015,39916,26807,8364,35171,26807,8364
19/08/2015,40726,27425,8597,36022,27425,8597
20/08/2015,39280,26648,7906,34554,26648,7906
21/08/2015,38038,24875,7687,32562,24875,7687
22/08/2015,34277,16622,6586,23208,16622,6586
23/08/2015,33071,16656,6486,23142,16656,6486
24/08/2015,38943,25831,8099,33930,25831,8099
25/08/2015,41655,27886,8890,36776,27886,8890
26/08/2015,42832,28948,8884,37832,28948,8884
27/08/2015,43173,28939,8930,37869,28939,8930
28/08/2015,41755,27111,8543,35654,27111,8543
29/08/2015,34381,17221,6639,23860,17221,6639
30/08/2015,32913,16592,6573,23165,16592,6573
31/08/2015,40119,26737,8387,35124,26737,8387
01/09/2015,43291,29224,9171,38395,29224,9171
02/09/2015,43225,29505,8994,38499,29505,8994
03/09/2015,42879,28849,8932,37781,28849,8932
04/09/2015,39956,25528,8037,33565,25528,8037
05/09/2015,34005,14926,6003,20929,14926,6003
06/09/2015,33199,13511,5312,18823,13511,5312
07/09/2015,33682,15834,6361,22195,15834,6361
08/09/2015,42766,28761,9096,37857,28761,9096
09/09/2015,44005,30329,9331,39660,30329,9331
10/09/2015,22253,15791,4479,20270,15791,4479
11/09/2015,47613,31333,9798,41131,31333,9798
12/09/2015,33661,18351,6973,25324,18351,6973
13/09/2015,34794,18661,7240,25901,18661,7240
14/09/2015,44668,28917,9245,38162,28917,9245
15/09/2015,48729,32220,10489,42709,32220,10489
16/09/2015,51179,34401,11243,45644,34401,11243
17/09/2015,50705,34062,10967,45029,34062,10967
18/09/2015,50285,32795,10557,43352,32795,10557
19/09/2015,43011,21675,9078,30753,21675,9078
20/09/2015,40462,21209,8428,29637,21209,8428
21/09/2015,47180,31967,10004,41971,31967,10004
22/09/2015,48685,33652,10444,44096,33652,10444
23/09/2015,48366,32207,10299,42506,32207,10299
24/09/2015,52706,35128,11193,46321,35128,11193
25/09/2015,51368,33418,10681,44099,33418,10681
26/09/2015,42560,22530,8882,31412,22530,8882
27/09/2015,38285,20579,8498,29077,20579,8498
28/09/2015,48011,32115,10409,42524,32115,10409
29/09/2015,48725,33112,10639,43751,33112,10639
30/09/2015,39445,27968,8617,36585,27968,8617
01/10/2015,34719,24682,7175,31857,24682,7175
02/10/2015,9444,7331,1701,9032,7331,1701
03/10/2015,16564,11597,3553,15150,11597,3553
04/10/2015,30214,17949,6913,24862,17949,6913
05/10/2015,44581,30788,9549,40337,30788,9549
06/10/2015,49719,34375,10807,45182,34375,10807
07/10/2015,50141,34942,10983,45925,34942,10983
08/10/2015,50179,34629,10632,45261,34629,10632
09/10/2015,37283,25435,7585,33020,25435,7585
10/10/2015,39345,20333,8031,28364,20333,8031
11/10/2015,38967,19486,7647,27133,19486,7647
12/10/2015,45584,28217,9212,37429,28217,9212
13/10/2015,49047,33304,10505,43809,33304,10505
14/10/2015,49998,34619,10840,45459,34619,10840
15/10/2015,48783,33728,10299,44027,33728,10299
16/10/2015,46484,31781,9552,41333,31781,9552
17/10/2015,31809,18602,6754,25356,18602,6754
18/10/2015,23978,14966,5245,20211,14966,5245
19/10/2015,36570,26092,7728,33820,26092,7728
20/10/2015,45376,31725,9782,41507,31725,9782
21/10/2015,49121,33863,10692,44555,33863,10692
22/10/2015,49604,34327,10542,44869,34327,10542
23/10/2015,44679,30549,9239,39788,30549,9239
24/10/2015,31713,18051,6964,25015,18051,6964
25/10/2015,29289,17593,6420,24013,17593,6420
26/10/2015,42165,29328,9000,38328,29328,9000
27/10/2015,44553,31563,9645,41208,31563,9645
28/10/2015,20736,15735,4339,20074,15735,4339
29/10/2015,45358,32245,9549,41794,32245,9549
30/10/2015,44518,30709,9069,39778,30709,9069
31/10/2015,31756,18553,6840,25393,18553,6840
01/11/2015,30622,17805,6635,24440,17805,6635
02/11/2015,44534,30369,9136,39505,30369,9136
03/11/2015,49326,33469,10298,43767,33469,10298
04/11/2015,49487,34102,10350,44452,34102,10350
05/11/2015,43006,30489,9010,39499,30489,9010
06/11/2015,47162,32271,9869,42140,32271,9869
07/11/2015,35586,20336,7626,27962,20336,7626
08/11/2015,32317,18485,7119,25604,18485,7119
09/11/2015,42262,29758,8956,38714,29758,8956
10/11/2015,21585,16392,4353,20745,16392,4353
11/11/2015,37705,26951,8244,35195,26951,8244
12/11/2015,37319,27582,7910,35492,27582,7910
13/11/2015,38970,28059,7925,35984,28059,7925
14/11/2015,25299,16039,5677,21716,16039,5677
15/11/2015,25990,16068,5948,22016,16068,5948
16/11/2015,40916,29159,8995,38154,29159,8995
17/11/2015,38939,28352,8511,36863,28352,8511
18/11/2015,41485,30471,9072,39543,30471,9072
19/11/2015,21890,16483,4609,21092,16483,4609
20/11/2015,38205,27525,8061,35586,27525,8061
21/11/2015,28038,17362,6226,23588,17362,6226
22/11/2015,23343,15015,5461,20476,15015,5461
23/11/2015,30136,22494,6178,28672,22494,6178
24/11/2015,32218,23971,6838,30809,23971,6838
25/11/2015,30295,22010,6400,28410,22010,6400
26/11/2015,13291,6898,2550,9448,6898,2550
27/11/2015,22824,13306,4308,17614,13306,4308
28/11/2015,15830,9367,3170,12537,9367,3170
29/11/2015,18452,11696,4127,15823,11696,4127
30/11/2015,30213,22418,6439,28857,22418,6439
01/12/2015,18399,14183,3725,17908,14183,3725
02/12/2015,23782,18204,4933,23137,18204,4933
03/12/2015,33917,25227,7314,32541,25227,7314
04/12/2015,34737,25823,7100,32923,25823,7100
05/12/2015,26358,16572,5858,22430,16572,5858
06/12/2015,24943,15646,5594,21240,15646,5594
07/12/2015,34139,24999,7271,32270,24999,7271
08/12/2015,35614,26439,7545,33984,26439,7545
09/12/2015,35306,26512,7451,33963,26512,7451
10/12/2015,39099,28527,8518,37045,28527,8518
11/12/2015,39060,28430,8175,36605,28430,8175
12/12/2015,31957,19459,7217,26676,19459,7217
13/12/2015,32001,18738,7138,25876,18738,7138
14/12/2015,32518,23639,6837,30476,23639,6837
15/12/2015,38661,28499,8185,36684,28499,8185
16/12/2015,35643,26496,7563,34059,26496,7563
17/12/2015,21961,16944,4496,21440,16944,4496
18/12/2015,30704,23325,6172,29497,23325,6172
19/12/2015,17778,12424,3954,16378,12424,3954
20/12/2015,17030,11505,3889,15394,11505,3889
21/12/2015,29800,22511,5882,28393,22511,5882
22/12/2015,22941,17631,4411,22042,17631,4411
23/12/2015,14817,11331,2921,14252,11331,2921
24/12/2015,18447,13025,3677,16702,13025,3677
25/12/2015,12333,4809,1709,6518,4809,1709
26/12/2015,13914,7650,2441,10091,7650,2441
27/12/2015,13177,7443,2544,9987,7443,2544
28/12/2015,18889,13094,3305,16399,13094,3305
29/12/2015,13347,10072,2487,12559,10072,2487
30/12/2015,22477,15783,4099,19882,15783,4099
31/12/2015,20376,13291,3957,17248,13291,3957
01/01/2016,11009,6322,2163,8485,6322,2163
02/01/2016,14587,8968,3122,12090,8968,3122
03/01/2016,15499,9903,3420,13323,9903,3420
04/01/2016,19593,15081,3829,18910,15081,3829
05/01/2016,18053,14093,3434,17527,14093,3434
06/01/2016,24569,18697,4950,23647,18697,4950
07/01/2016,27773,21080,5733,26813,21080,5733
08/01/2016,28709,21575,5922,27497,21575,5922
09/01/2016,20846,14215,4895,19110,14215,4895
10/01/2016,14275,10098,3213,13311,10098,3213
11/01/2016,22937,17843,4507,22350,17843,4507
12/01/2016,25211,19571,5111,24682,19571,5111
13/01/2016,21133,16636,4110,20746,16636,4110
14/01/2016,23780,18616,4646,23262,18616,4646
15/01/2016,28435,21505,5815,27320,21505,5815
16/01/2016,19178,12610,4460,17070,12610,4460
17/01/2016,12024,8139,2699,10838,8139,2699
18/01/2016,12718,9500,2689,12189,9500,2689
19/01/2016,17281,13705,3273,16978,13705,3273
20/01/2016,23420,18215,4739,22954,18215,4739
21/01/2016,23672,18421,4755,23176,18421,4755
22/01/2016,20950,16508,4035,20543,16508,4035
27/01/2016,6761,5420,1189,6609,5420,1189
28/01/2016,11946,9612,2113,11725,9612,2113
29/01/2016,16028,12679,2982,15661,12679,2982
30/01/2016,12973,9218,2919,12137,9218,2919
31/01/2016,16118,11084,3734,14818,11084,3734
01/02/2016,24334,18810,4760,23570,18810,4760
02/02/2016,28528,21850,5741,27591,21850,5741
03/02/2016,16203,12683,3190,15873,12683,3190
04/02/2016,27766,21176,5595,26771,21176,5595
05/02/2016,13670,10837,2510,13347,10837,2510
06/02/2016,16933,11681,3846,15527,11681,3846
07/02/2016,17605,11685,4082,15767,11685,4082
08/02/2016,19026,15082,3506,18588,15082,3506
09/02/2016,22741,17644,4548,22192,17644,4548
10/02/2016,22420,17501,4457,21958,17501,4457
11/02/2016,18748,14867,3534,18401,14867,3534
12/02/2016,16449,13080,3017,16097,13080,3017
13/02/2016,6625,5063,1370,6433,5063,1370
14/02/2016,4653,3562,892,4454,3562,892
15/02/2016,5884,4564,1146,5710,4564,1146
16/02/2016,14542,11627,2694,14321,11627,2694
17/02/2016,23572,18381,4562,22943,18381,4562
18/02/2016,22261,17280,4250,21530,17280,4250
19/02/2016,21959,16992,4139,21131,16992,4139
20/02/2016,24484,15122,5255,20377,15122,5255
21/02/2016,20052,12452,4405,16857,12452,4405
22/02/2016,28233,21051,5711,26762,21051,5711
23/02/2016,16133,12527,3304,15831,12527,3304
24/02/2016,9761,7795,1800,9595,7795,1800
25/02/2016,25102,19313,4984,24297,19313,4984
26/02/2016,22573,17391,4336,21727,17391,4336
27/02/2016,17226,11547,3832,15379,11547,3832
28/02/2016,25437,14586,5487,20073,14586,5487
29/02/2016,27954,21067,5634,26701,21067,5634
01/03/2016,30509,22712,6161,28873,22712,6161
02/03/2016,26195,20117,5243,25360,20117,5243
03/03/2016,24061,18384,4775,23159,18384,4775
04/03/2016,17369,13408,3388,16796,13408,3388
05/03/2016,18023,11863,4126,15989,11863,4126
06/03/2016,18832,12130,4480,16610,12130,4480
07/03/2016,31492,23009,6518,29527,23009,6518
08/03/2016,36521,26501,7657,34158,26501,7657
09/03/2016,41490,29160,8977,38137,29160,8977
10/03/2016,42252,29534,9012,38546,29534,9012
11/03/2016,38195,26436,7846,34282,26436,7846
12/03/2016,32771,17593,6685,24278,17593,6685
13/03/2016,27550,15281,5860,21141,15281,5860
14/03/2016,10930,8450,1993,10443,8450,1993
15/03/2016,31596,22866,6620,29486,22866,6620
16/03/2016,36067,25526,7522,33048,25526,7522
17/03/2016,35390,25377,7503,32880,25377,7503
18/03/2016,34647,24756,7004,31760,24756,7004
19/03/2016,24048,14479,5317,19796,14479,5317
20/03/2016,16678,10922,3880,14802,10922,3880
21/03/2016,26414,19552,5190,24742,19552,5190
22/03/2016,33497,24118,6977,31095,24118,6977
23/03/2016,40983,28636,8597,37233,28636,8597
24/03/2016,36495,25717,7204,32921,25717,7204
25/03/2016,34097,22603,6925,29528,22603,6925
26/03/2016,27478,14234,5352,19586,14234,5352
27/03/2016,22483,12232,4241,16473,12232,4241
28/03/2016,20345,14739,4099,18838,14739,4099
29/03/2016,31481,22729,6416,29145,22729,6416
30/03/2016,33684,24047,7035,31082,24047,7035
31/03/2016,38348,27108,7948,35056,27108,7948
01/04/2016,34449,24048,7185,31233,24048,7185
02/04/2016,21839,14210,4453,18663,14210,4453
03/04/2016,15322,10508,3362,13870,10508,3362
04/04/2016,12302,9706,2285,11991,9706,2285
05/04/2016,26238,19887,5208,25095,19887,5208
06/04/2016,29365,21774,6188,27962,21774,6188
07/04/2016,30402,23109,6308,29417,23109,6308
08/04/2016,30817,22882,6313,29195,22882,6313
09/04/2016,12702,9074,2731,11805,9074,2731
10/04/2016,23229,14121,5135,19256,14121,5135
11/04/2016,32048,23390,6538,29928,23390,6538
12/04/2016,23765,17722,4931,22653,17722,4931
13/04/2016,37539,26950,8042,34992,26950,8042
14/04/2016,38505,27531,8128,35659,27531,8128
15/04/2016,39676,27752,8041,35793,27752,8041
16/04/2016,36148,19427,7384,26811,19427,7384
17/04/2016,38843,19661,7587,27248,19661,7587
18/04/2016,43994,29525,9079,38604,29525,9079
19/04/2016,46075,31972,9925,41897,31972,9925
20/04/2016,44547,30828,9473,40301,30828,9473
21/04/2016,45570,31495,9564,41059,31495,9564
22/04/2016,48815,29836,9158,38994,29836,9158
23/04/2016,33647,17543,6703,24246,17543,6703
24/04/2016,37866,19001,7697,26698,19001,7697
25/04/2016,42308,28261,8304,36565,28261,8304
26/04/2016,34643,24991,6811,31802,24991,6811
27/04/2016,41931,28898,8404,37302,28898,8404
28/04/2016,37428,26251,7404,33655,26251,7404
29/04/2016,34878,24454,6727,31181,24454,6727
30/04/2016,38258,19325,7442,26767,19325,7442
01/05/2016,10697,7427,2063,9490,7427,2063
02/05/2016,38537,26893,7821,34714,26893,7821
03/05/2016,22858,16721,4570,21291,16721,4570
04/05/2016,31619,23008,6384,29392,23008,6384
05/05/2016,39903,28533,8042,36575,28533,8042
06/05/2016,18860,14230,3509,17739,14230,3509
07/05/2016,31078,18113,6514,24627,18113,6514
08/05/2016,31197,17256,6364,23620,17256,6364
09/05/2016,45724,31122,9529,40651,31122,9529
10/05/2016,44849,31603,9638,41241,31603,9638
11/05/2016,51181,35043,10940,45983,35043,10940
12/05/2016,52273,34899,10929,45828,34899,10929
13/05/2016,32391,22898,6516,29414,22898,6516
14/05/2016,42063,21988,8566,30554,21988,8566
15/05/2016,28661,16497,6012,22509,16497,6012
16/05/2016,42787,28967,8683,37650,28967,8683
17/05/2016,43396,30504,8873,39377,30504,8873
18/05/2016,44803,30962,9464,40426,30962,9464
19/05/2016,49182,33667,10257,43924,33667,10257
20/05/2016,52543,34231,10599,44830,34231,10599
21/05/2016,30519,17425,6188,23613,17425,6188
22/05/2016,37802,20114,7790,27904,20114,7790
23/05/2016,48578,32509,10082,42591,32509,10082
24/05/2016,34796,24797,7388,32185,24797,7388
25/05/2016,53439,36312,11635,47947,36312,11635
26/05/2016,52133,35395,11201,46596,35395,11201
27/05/2016,46937,30642,9917,40559,30642,9917
28/05/2016,34222,16382,6473,22855,16382,6473
29/05/2016,36877,15500,6433,21933,15500,6433
30/05/2016,32619,16685,6580,23265,16685,6580
31/05/2016,49756,33400,10887,44287,33400,10887
01/06/2016,54665,37132,12120,49252,37132,12120
02/06/2016,54401,37047,11873,48920,37047,11873
03/06/2016,38975,27194,8297,35491,27194,8297
04/06/2016,40977,21504,8796,30300,21504,8796
05/06/2016,22397,13993,5127,19120,13993,5127
06/06/2016,52149,34930,11361,46291,34930,11361
07/06/2016,51812,36118,11375,47493,36118,11375
08/06/2016,42250,30866,9206,40072,30866,9206
09/06/2016,52905,36961,11246,48207,36961,11246
10/06/2016,53299,35642,11412,47054,35642,11412
11/06/2016,41030,22186,8909,31095,22186,8909
12/06/2016,40637,21575,8744,30319,21575,8744
13/06/2016,49069,33843,10344,44187,33843,10344
14/06/2016,54813,37754,12084,49838,37754,12084
15/06/2016,55049,37712,12239,49951,37712,12239
16/06/2016,46198,32389,9981,42370,32389,9981
17/06/2016,54236,35481,11232,46713,35481,11232
18/06/2016,48901,22687,9181,31868,22687,9181
19/06/2016,45270,21137,8492,29629,21137,8492
20/06/2016,52247,35091,11392,46483,35091,11392
21/06/2016,53564,36899,12070,48969,36899,12070
22/06/2016,55749,38501,12547,51048,38501,12547
23/06/2016,53206,37084,11750,48834,37084,11750
24/06/2016,54186,36063,11494,47557,36063,11494
25/06/2016,43000,23072,9286,32358,23072,9286
26/06/2016,42992,22428,9051,31479,22428,9051
27/06/2016,47023,31874,9947,41821,31874,9947
28/06/2016,49593,34680,10969,45649,34680,10969
29/06/2016,54882,37827,12205,50032,37827,12205
30/06/2016,54843,37794,11888,49682,37794,11888
01/07/2016,39669,27089,8164,35252,27088,8164
02/07/2016,35837,17180,7053,24233,17180,7053
03/07/2016,35348,15011,6246,21257,15011,6246
04/07/2016,34860,15631,6575,22206,15631,6575
05/07/2016,43744,29401,9403,38804,29401,9403
06/07/2016,51353,35063,11418,46481,35063,11418
07/07/2016,48742,33695,10829,44524,33695,10829
08/07/2016,44419,30305,9666,39970,30305,9665
09/07/2016,38142,21042,8523,29565,21042,8523
10/07/2016,41991,22625,9092,31717,22625,9092
11/07/2016,52870,35743,11525,47268,35743,11525
12/07/2016,56537,38489,12593,51081,38488,12593
13/07/2016,55486,38164,12029,50143,38124,12019
14/07/2016,50350,34596,11241,45739,34542,11197
15/07/2016,48572,32795,10433,43082,32707,10375
16/07/2016,38406,20388,7940,28255,20338,7917
17/07/2016,41347,21333,8536,29857,21326,8531
18/07/2016,43687,30006,9471,39472,30003,9469
19/07/2016,54593,37327,12174,49490,37317,12173
20/07/2016,57225,38926,12797,51709,38920,12789
21/07/2016,54842,37693,11987,49578,37625,11953
22/07/2016,49191,33292,10693,43843,33211,10632
23/07/2016,37523,20394,7927,28066,20229,7837
24/07/2016,39637,20859,8703,29241,20698,8543
25/07/2016,35379,24293,7342,31510,24212,7298
26/07/2016,52912,36364,11746,47927,36275,11652
27/07/2016,54163,37038,12237,49098,36946,12152
28/07/2016,50151,34771,10865,45438,34679,10759
29/07/2016,37703,25149,7979,32968,25049,7919
30/07/2016,27780,15561,5855,21087,15344,5743
31/07/2016,27651,16145,6036,21972,16018,5954
01/08/2016,49401,34063,10504,44403,33966,10437
02/08/2016,56764,38644,12197,50618,38501,12117
03/08/2016,57003,38473,12265,50588,38367,12221
04/08/2016,56604,38280,12157,50253,38178,12075
05/08/2016,53297,35271,11239,46314,35152,11162
06/08/2016,44213,22186,9180,30846,21875,8971
07/08/2016,43631,21814,9159,30554,21589,8965
08/08/2016,52262,34689,11364,45839,34563,11276
09/08/2016,56112,37491,12496,49808,37378,12430
10/08/2016,50114,34569,10962,45382,34470,10912
11/08/2016,47430,32735,10173,42726,32608,10118
12/08/2016,44750,30268,9544,39615,30121,9494
13/08/2016,38912,19940,8462,27736,19589,8147
14/08/2016,32961,18361,7364,25332,18121,7211
15/08/2016,49063,33058,10573,43380,32903,10477
16/08/2016,50426,34497,11102,45337,34341,10996
17/08/2016,53989,36960,11811,48507,36786,11721
18/08/2016,53218,36364,11353,47425,36141,11284
19/08/2016,51669,34023,11230,44944,33808,11136
20/08/2016,45817,22241,9546,31127,21895,9232
21/08/2016,35051,18435,7553,25647,18242,7405
22/08/2016,54404,36254,11790,47863,36133,11730
23/08/2016,58674,39445,12958,52136,39251,12885
24/08/2016,58154,39122,13094,51981,38944,13037
25/08/2016,53487,36399,11718,47858,36232,11626
26/08/2016,52037,34462,11479,45460,34157,11303
27/08/2016,45674,24015,10205,33131,23375,9756
28/08/2016,44639,23388,9933,32283,22783,9500
29/08/2016,53288,35709,11893,47191,35465,11726
30/08/2016,57405,39110,13255,51841,38825,13016
31/08/2016,57214,39275,13030,51845,39018,12827
01/09/2016,38187,27418,7968,35180,27267,7913
02/09/2016,53007,33949,11462,44776,33566,11210
03/09/2016,41630,19864,8471,27058,19109,7949
04/09/2016,46023,20254,9234,27694,19278,8416
05/09/2016,45436,22536,9723,31081,21907,9174
06/09/2016,52447,36275,11422,47342,36059,11283
07/09/2016,60500,41647,13714,54963,41403,13560
08/09/2016,61596,41743,13913,55293,41542,13751
09/09/2016,56813,38577,12626,50762,38323,12439
10/09/2016,48455,26481,11165,36785,25965,10820
11/09/2016,52245,28306,12450,39576,27634,11942
12/09/2016,61103,41023,13752,54220,40687,13533
13/09/2016,64839,44353,15147,59005,44049,14956
14/09/2016,59203,40806,13409,53811,40540,13271
15/09/2016,67331,46249,15181,60954,45967,14987
16/09/2016,65275,43713,14544,57525,43265,14260
17/09/2016,59200,31579,13613,44000,30850,13150
18/09/2016,51686,28600,11901,39677,28119,11558
19/09/2016,34217,24603,7536,31963,24491,7472
20/09/2016,64891,44684,14919,59094,44323,14771
21/09/2016,65463,44756,15261,59549,44399,15150
22/09/2016,67810,46292,15531,61337,45951,15386
23/09/2016,65517,43740,14983,58068,43298,14770
24/09/2016,53259,29128,12496,40599,28509,12090
25/09/2016,53568,28784,12696,40467,28210,12257
26/09/2016,61386,41442,14053,55030,41166,13864
27/09/2016,61346,42137,14359,56039,41859,14180
28/09/2016,59464,41869,13715,55266,41680,13586
29/09/2016,55578,39786,12324,51798,39562,12236
30/09/2016,21381,16461,4112,20503,16406,4097
01/10/2016,39811,24457,9485,33396,24125,9271
02/10/2016,41023,24005,9760,33074,23597,9477
03/10/2016,56384,38034,12435,49868,37644,12224
04/10/2016,60379,41857,13908,55314,41569,13745
05/10/2016,65053,44913,15134,59609,44648,14961
06/10/2016,67585,46140,15374,61007,45843,15164
07/10/2016,65896,43696,14518,57562,43255,14307
08/10/2016,34625,20209,7943,27508,19763,7745
09/10/2016,21689,14267,5009,19036,14087,4949
10/10/2016,52255,33782,11718,44844,33398,11446
11/10/2016,58768,40682,13385,53504,40333,13171
12/10/2016,57690,39420,13162,52176,39153,13023
13/10/2016,61217,42967,13585,56100,42654,13446
14/10/2016,60566,41137,13415,53905,40715,13190
15/10/2016,51992,28586,12163,39274,27779,11495
16/10/2016,48870,26962,11494,37258,26269,10989
17/10/2016,62657,42257,14271,55819,41824,13995
18/10/2016,68240,46002,15854,61039,45458,15581
19/10/2016,69772,46546,16137,61938,46047,15891
20/10/2016,63674,43928,14202,57483,43483,14000
21/10/2016,40873,29557,8894,38231,29411,8820
22/10/2016,25303,17319,5724,22725,17069,5656
23/10/2016,41463,24020,9752,32894,23444,9450
24/10/2016,55261,38299,12456,50281,37987,12294
25/10/2016,52681,37544,11987,49181,37320,11861
26/10/2016,52484,37376,11869,48851,37124,11727
27/10/2016,21058,16057,4411,20402,16010,4392
28/10/2016,46242,33913,9783,43421,33733,9688
29/10/2016,42514,25027,9778,34066,24567,9499
30/10/2016,37765,20960,8696,28917,20507,8410
31/10/2016,50082,35002,10730,45188,34643,10545
01/11/2016,55967,39495,12841,51975,39254,12721
02/11/2016,62144,43051,14474,56816,42613,14203
03/11/2016,59641,42274,13531,55387,41978,13409
04/11/2016,57877,39992,12594,51867,39487,12380
05/11/2016,48689,27294,11069,37252,26590,10662
06/11/2016,39413,23758,9351,32215,23195,9020
07/11/2016,49890,35316,10969,45771,34973,10798
08/11/2016,56603,39406,12999,51853,39067,12786
09/11/2016,38060,28434,8180,36418,28300,8118
10/11/2016,50871,36715,11201,47558,36482,11076
11/11/2016,45832,32094,9894,41469,31782,9687
12/11/2016,34667,21135,7967,28465,20715,7750
13/11/2016,36810,22062,8718,29935,21559,8376
14/11/2016,48834,34878,10906,45452,34649,10803
15/11/2016,22896,17347,4885,22161,17304,4857
16/11/2016,53342,38631,12115,50420,38413,12007
17/11/2016,53895,38790,12221,50646,38536,12110
18/11/2016,53390,37860,11860,49145,37464,11681
19/11/2016,41213,25009,10031,34191,24485,9706
20/11/2016,20617,14050,5056,18916,13932,4984
21/11/2016,32972,25194,6930,32012,25118,6894
22/11/2016,36749,27752,7831,35366,27609,7757
23/11/2016,34466,25509,7290,32587,25355,7232
24/11/2016,12122,7578,2715,10060,7419,2641
25/11/2016,20980,13606,4368,17531,13295,4236
26/11/2016,23811,14384,5425,19194,14005,5189
27/11/2016,24077,15444,5763,20900,15282,5618
28/11/2016,42091,30878,9301,39976,30745,9231
29/11/2016,14588,11314,2981,14260,11287,2973
30/11/2016,24435,18716,5186,23867,18687,5180
01/12/2016,43242,32217,9350,41350,32050,9300
02/12/2016,42371,31305,9161,40188,31093,9095
03/12/2016,29854,19831,7301,26680,19519,7161
04/12/2016,27455,17923,6610,24050,17621,6429
05/12/2016,35932,26586,7771,34180,26448,7732
06/12/2016,33332,24779,7343,31944,24646,7298
07/12/2016,38021,28563,8216,36643,28458,8185
08/12/2016,39626,29754,8745,38309,29623,8686
09/12/2016,33547,25430,7164,32459,25334,7125
10/12/2016,22379,15488,5431,20727,15370,5357
11/12/2016,17799,12478,4283,16627,12395,4232
12/12/2016,29037,22055,6144,28083,21965,6118
13/12/2016,39025,29388,8444,37645,29267,8378
14/12/2016,37808,28538,8144,36562,28455,8107
15/12/2016,25015,19691,4816,24465,19663,4802
16/12/2016,24490,19171,4721,23837,19126,4711
17/12/2016,6993,5539,1284,6797,5521,1276
18/12/2016,16295,11840,3856,15627,11798,3829
19/12/2016,25649,19831,5190,24942,19778,5164
20/12/2016,27685,21412,5481,26818,21350,5468
21/12/2016,30625,23449,6140,29446,23340,6106
22/12/2016,30889,23591,6146,29633,23515,6118
23/12/2016,26344,19544,5399,24789,19419,5370
24/12/2016,8014,5743,1764,7429,5692,1737
25/12/2016,9924,5181,1890,6733,4947,1786
26/12/2016,10775,7264,2278,9425,7187,2238
27/12/2016,25955,17677,5339,22701,17468,5233
28/12/2016,23601,16844,4617,21098,16559,4539
29/12/2016,13207,10337,2390,12659,10281,2378
30/12/2016,21375,14987,4250,18941,14792,4149
31/12/2016,15928,10192,3497,13418,9988,3430
01/01/2017,16009,9082,3434,12173,8859,3314
02/01/2017,8921,6394,1888,8195,6330,1865
03/01/2017,14198,11226,2662,13849,11197,2652
04/01/2017,34039,25161,7142,32182,25087,7095
05/01/2017,28393,21814,5682,27380,21719,5661
06/01/2017,24177,18779,4694,23430,18745,4685
07/01/2017,4425,3397,931,4295,3375,920
08/01/2017,6417,5002,1287,6269,4985,1284
09/01/2017,15856,12809,2783,15585,12802,2783
10/01/2017,23232,18258,4550,22780,18232,4548
11/01/2017,32419,24538,6936,31359,24459,6900
12/01/2017,39783,29714,8531,38036,29572,8464
13/01/2017,33611,25250,6890,31969,25154,6815
14/01/2017,13819,9716,3267,12843,9629,3214
15/01/2017,17384,11617,4289,15778,11540,4238
16/01/2017,24110,17234,5421,22471,17105,5366
17/01/2017,18646,14469,3767,18212,14454,3758
18/01/2017,30857,23733,6431,30074,23664,6410
19/01/2017,36561,27672,7564,35077,27553,7524
20/01/2017,26752,20543,5405,25871,20476,5395
21/01/2017,26610,17949,6225,23967,17792,6175
22/01/2017,20523,14114,4776,18711,13982,4729
23/01/2017,15822,12404,3027,15412,12389,3023
24/01/2017,13171,10448,2479,12906,10432,2474
25/01/2017,36931,27876,7843,35596,27789,7807
26/01/2017,33002,25086,6904,31885,25016,6869
27/01/2017,32394,24842,6569,31298,24766,6532
28/01/2017,21302,14880,5165,19887,14769,5118
29/01/2017,22527,15454,5371,20629,15322,5307
30/01/2017,29616,22698,6117,28713,22624,6089
31/01/2017,25169,19690,4962,24616,19660,4956
01/02/2017,35221,26936,7311,34151,26857,7294
02/02/2017,34517,26228,7308,33371,26106,7265
03/02/2017,29632,22512,6227,28647,22432,6215
04/02/2017,19204,13445,4593,17877,13334,4543
05/02/2017,20059,14090,4887,18850,14001,4849
06/02/2017,33415,25111,7128,32060,24982,7078
07/02/2017,23053,17801,4834,22593,17770,4823
08/02/2017,40428,29827,8980,38623,29693,8930
10/02/2017,1997,1622,335,1947,1612,335
11/02/2017,8959,6504,2030,8465,6459,2006
12/02/2017,5801,4534,1115,5636,4522,1114
13/02/2017,23857,18825,4590,23370,18782,4588
14/02/2017,29668,22871,6073,28915,22842,6073
15/02/2017,32052,24519,6653,31060,24427,6633
16/02/2017,29120,22509,5953,28389,22455,5934
17/02/2017,28735,21970,5829,27660,21848,5812
18/02/2017,30571,18534,6983,24712,17977,6735
19/02/2017,36963,19663,8234,26400,18803,7597
20/02/2017,32292,20493,7387,27065,19985,7080
21/02/2017,32643,24275,6787,30886,24144,6742
22/02/2017,38119,28343,8224,36347,28192,8155
23/02/2017,42434,30489,9207,39302,30247,9055
24/02/2017,47031,32633,10139,42047,32149,9898
25/02/2017,33343,20393,8054,27594,19843,7751
26/02/2017,24714,16214,5965,21783,15958,5825
27/02/2017,35984,26640,7783,34243,26521,7722
28/02/2017,41835,30863,9176,39763,30661,9102
01/03/2017,40592,30126,8985,38917,29996,8921
02/03/2017,35739,26910,7391,34075,26751,7324
03/03/2017,31105,23420,6429,29676,23290,6386
04/03/2017,15646,11206,3672,14731,11090,3641
05/03/2017,15919,11368,3655,14864,11258,3606
06/03/2017,32467,24423,6746,31056,24346,6710
07/03/2017,29683,22720,6129,28748,22637,6111
08/03/2017,43469,31622,9553,40890,31435,9455
09/03/2017,45252,33081,9754,42452,32844,9608
10/03/2017,18412,14588,3402,17936,14548,3388
11/03/2017,15185,10919,3508,14319,10826,3493
12/03/2017,13442,9742,3096,12763,9690,3073
13/03/2017,27417,20956,5637,26484,20875,5609
17/03/2017,7098,5477,1309,6717,5427,1290
18/03/2017,4106,3100,827,3895,3083,812
19/03/2017,10550,7398,2352,9597,7313,2284
20/03/2017,27378,20672,5586,26149,20595,5554
21/03/2017,36824,27408,7796,34992,27268,7724
22/03/2017,26927,20954,5280,26114,20858,5256
23/03/2017,29885,22718,6015,28565,22589,5976
24/03/2017,34018,25528,6875,32214,25401,6813
25/03/2017,29646,18616,6768,24710,18180,6530
26/03/2017,19893,13532,4628,17877,13350,4527
27/03/2017,26301,19813,5372,25052,19712,5340
28/03/2017,21589,16780,4294,20975,16713,4262
29/03/2017,42430,31026,8915,39503,30735,8768
30/03/2017,39746,29110,8255,36992,28881,8111
31/03/2017,6946,5538,1247,6770,5526,1244
01/04/2017,23849,16361,5565,21568,16151,5417
02/04/2017,39780,22121,9431,30261,21420,8841
03/04/2017,43485,30896,9604,40109,30628,9481
04/04/2017,29991,22936,6128,29000,22884,6116
05/04/2017,47636,34088,10335,43873,33731,10142
06/04/2017,18020,14050,3597,17616,14025,3591
07/04/2017,35779,27026,7240,34141,26928,7213
08/04/2017,35936,21451,8522,28969,20916,8053
09/04/2017,43896,23608,10044,32180,22811,9369
10/04/2017,50424,33301,11364,43835,32854,10981
11/04/2017,57310,37500,12459,48887,36881,12006
12/04/2017,51188,35647,11553,46520,35227,11293
13/04/2017,52915,35462,11104,45655,34928,10727
14/04/2017,52232,32188,10963,41912,31492,10420
15/04/2017,42531,22458,9164,30055,21543,8512
16/04/2017,48140,23021,9697,30539,21808,8731
17/04/2017,53247,35328,11331,45858,34878,10980
18/04/2017,53809,36951,11565,47755,36485,11270
19/04/2017,45787,33170,10062,42866,32949,9917
20/04/2017,44264,31549,9636,40741,31249,9492
21/04/2017,39868,28745,8333,36616,28435,8181
22/04/2017,34596,21900,9381,24908,18422,6486
23/04/2017,49107,26432,11200,36254,25639,10615
24/04/2017,48692,34222,10597,44239,33900,10339
25/04/2017,20332,15333,4143,19309,15229,4080
26/04/2017,37727,27763,7949,35334,27513,7821
27/04/2017,52035,36360,11181,46910,35936,10974
28/04/2017,62199,40959,13222,52922,40160,12762
29/04/2017,57701,30008,12657,40659,28890,11769
30/04/2017,42928,24018,9702,32434,23258,9176
01/05/2017,56218,37614,12275,48845,36963,11882
02/05/2017,61207,41591,13433,54043,40973,13070
03/05/2017,59252,40683,13137,53014,40187,12827
04/05/2017,57429,39598,12505,51334,39137,12197
05/05/2017,24009,18204,4735,22746,18063,4683
06/05/2017,46618,27280,10779,36966,26569,10397
07/05/2017,34293,20640,7860,27664,20080,7584
08/05/2017,51553,36137,11257,46702,35686,11016
09/05/2017,56461,39973,12625,51913,39518,12395
10/05/2017,58454,40969,13108,53407,40553,12854
11/05/2017,57208,40189,12646,52103,39760,12343
12/05/2017,56675,39073,12455,50577,38483,12094
13/05/2017,5704,4308,1070,5301,4251,1050
14/05/2017,38729,22899,9144,30950,22241,8709
15/05/2017,54715,38521,12151,49958,38062,11896
16/05/2017,64504,44134,14695,57781,43504,14277
17/05/2017,65794,45116,15228,59255,44384,14871
18/05/2017,63753,43469,14386,56835,42844,13991
19/05/2017,62143,41850,13941,54392,40914,13478
20/05/2017,47859,27491,10988,36492,26200,10292
21/05/2017,54874,29140,12520,39467,27755,11712
22/05/2017,24627,18544,5130,23477,18384,5093
23/05/2017,60032,41723,13660,54641,41258,13383
24/05/2017,60622,42015,13571,54837,41529,13308
25/05/2017,17495,13539,3303,16729,13461,3268
26/05/2017,53768,35411,11971,46353,34814,11539
27/05/2017,46534,22749,9912,30346,21409,8937
28/05/2017,46727,21054,10106,28441,19535,8906
29/05/2017,26322,16066,6036,21495,15679,5816
30/05/2017,50194,35694,10975,46074,35302,10772
31/05/2017,59495,40606,13806,53594,40086,13508
01/06/2017,67403,45621,15536,60168,45013,15155
02/06/2017,66907,44589,15128,58373,43755,14618
03/06/2017,56264,30596,13398,41745,29285,12460
04/06/2017,40138,23599,9532,31664,22701,8963
05/06/2017,55883,38667,12474,50358,38173,12185
06/06/2017,41268,30142,9056,38858,29939,8919
07/06/2017,64453,44271,15099,58504,43709,14795
08/06/2017,62653,43075,14083,56147,42463,13684
09/06/2017,66506,43877,15227,57765,43027,14738
10/06/2017,57087,31060,13621,42219,29571,12648
11/06/2017,51427,28288,12419,38634,27064,11570
12/06/2017,57871,39179,13469,51670,38590,13080
13/06/2017,60921,41985,14371,55563,41484,14079
14/06/2017,60513,41483,14105,54710,40916,13794
15/06/2017,64763,44102,14953,57971,43373,14598
16/06/2017,56403,38992,12884,50882,38281,12601
17/06/2017,34900,20677,8349,27959,20005,7954
18/06/2017,49472,27394,11840,37554,26417,11137
19/06/2017,38310,26619,8492,34480,26199,8281
20/06/2017,64673,44352,15325,58628,43695,14933
21/06/2017,67218,46187,15787,61031,45527,15504
22/06/2017,66308,45051,15521,59527,44335,15192
23/06/2017,55323,37800,12386,49166,37089,12077
24/06/2017,52153,28770,12074,38864,27485,11379
25/06/2017,54655,29765,12639,40047,28238,11809
26/06/2017,62669,41818,14265,54817,40924,13893
27/06/2017,64767,43917,15334,58254,43251,15003
28/06/2017,67752,46432,15618,60840,45625,15215
29/06/2017,64272,44241,14767,58027,43580,14447
30/06/2017,58662,39381,13501,51740,38691,13049
01/07/2017,36737,19853,8468,26923,18972,7951
02/07/2017,43036,20845,9343,27758,19356,8402
03/07/2017,48193,27807,10641,36099,26328,9771
04/07/2017,49924,24930,11359,33375,23191,10184
05/07/2017,60321,40186,13571,52556,39387,13169
06/07/2017,62147,42204,14223,55289,41455,13834
07/07/2017,44068,30515,9841,39521,29931,9590
08/07/2017,55015,30321,13118,41179,28980,12199
09/07/2017,57118,31273,13551,42200,29673,12527
10/07/2017,60907,41201,14408,54587,40536,14051
11/07/2017,61671,42616,14611,56263,41935,14328
12/07/2017,61786,42944,14568,56587,42283,14304
13/07/2017,56475,39243,12971,51310,38614,12696
14/07/2017,31851,23277,6600,29467,22980,6487
15/07/2017,56499,30876,13403,41836,29318,12518
16/07/2017,56833,30917,13394,41702,29291,12411
17/07/2017,62555,42246,14757,55858,41477,14381
18/07/2017,66234,45042,15770,59623,44235,15388
19/07/2017,63915,43628,14899,57497,42928,14569
20/07/2017,59663,41318,13514,53856,40627,13229
21/07/2017,60072,40560,13650,52909,39695,13214
22/07/2017,48011,26687,11328,35855,25373,10482
23/07/2017,46942,26109,11417,35534,24882,10652
24/07/2017,43792,30770,9835,40076,30435,9641
25/07/2017,65336,44997,15266,59221,44349,14872
26/07/2017,70323,47774,16270,62755,46963,15792
27/07/2017,65769,45339,15099,59321,44660,14661
28/07/2017,63899,42445,14582,55896,41735,14161
29/07/2017,52947,29579,12136,39607,28311,11296
30/07/2017,59342,31105,13629,41758,29328,12430
31/07/2017,64218,42777,14799,56408,42071,14337
01/08/2017,66677,45236,15858,59958,44511,15447
02/08/2017,56184,39594,13109,49055,37230,11825
03/08/2017,66149,45470,15314,59135,44381,14754
04/08/2017,56394,37673,12641,48964,36765,12199
05/08/2017,58971,31094,13550,41837,29325,12512
06/08/2017,56476,29934,12886,39774,28039,11735
07/08/2017,23395,17462,4907,22093,17264,4829
08/08/2017,65233,44543,15132,58671,43882,14789
09/08/2017,67884,45759,15859,60422,45015,15407
10/08/2017,66249,44635,15353,58889,43919,14970
11/08/2017,63140,41240,14380,54019,40240,13779
12/08/2017,60540,30492,14065,41215,28480,12735
13/08/2017,57518,30006,13387,40462,28166,12296
14/08/2017,61482,40805,14142,53557,39861,13696
15/08/2017,52461,36599,12206,48089,36146,11943
16/08/2017,68436,46140,15948,60944,45412,15532
17/08/2017,66656,44536,15498,58794,43718,15076
18/08/2017,36620,25465,8188,33068,25062,8006
19/08/2017,62442,31328,14787,42724,29384,13340
20/08/2017,55442,29934,13247,40559,28417,12142
21/08/2017,61059,40481,14175,53293,39585,13708
22/08/2017,60541,40731,14401,53944,40003,13941
23/08/2017,65070,44143,15349,58223,43294,14929
24/08/2017,66307,44508,15439,58574,43624,14950
25/08/2017,64217,41709,14785,54912,40759,14153
26/08/2017,50109,28246,12358,38891,27154,11737
27/08/2017,54598,29568,13265,40075,27985,12090
28/08/2017,60886,40848,14175,53893,40170,13723
29/08/2017,35152,25328,7904,32905,25097,7808
30/08/2017,65329,44534,15176,58586,43757,14829
31/08/2017,64881,43970,14901,57635,43115,14520
01/09/2017,54881,36835,12831,48636,36167,12469
02/09/2017,37812,19771,8642,26006,18264,7742
03/09/2017,30955,16921,6760,22243,16036,6207
04/09/2017,55285,28004,12422,37508,26310,11198
05/09/2017,65445,44475,15168,58417,43685,14732
06/09/2017,42295,31018,9295,39902,30740,9162
07/09/2017,69519,48070,16211,63274,47410,15864
08/09/2017,69574,47211,15973,61891,46370,15521
09/09/2017,60155,34362,14570,46595,32911,13684
10/09/2017,60711,34000,15022,46665,32527,14138
11/09/2017,71917,48408,16568,63457,47438,16019
12/09/2017,74580,50820,17764,67396,50049,17347
13/09/2017,69566,48148,16082,63144,47468,15676
14/09/2017,72071,49865,16853,65586,49120,16466
15/09/2017,72297,48758,16789,64016,47815,16201
16/09/2017,61036,34456,15092,46845,32858,13987
17/09/2017,59967,33965,14644,46064,32431,13633
18/09/2017,64130,43842,15035,57697,43084,14613
19/09/2017,57910,41228,13423,53860,40715,13145
20/09/2017,71150,49458,16910,65362,48817,16545
21/09/2017,67742,45968,16230,60923,45131,15792
22/09/2017,70127,46897,16344,61629,45916,15713
23/09/2017,62687,35258,15178,47506,33481,14025
24/09/2017,57458,32609,14273,44233,31066,13167
25/09/2017,69200,46998,16580,62362,46207,16155
26/09/2017,71518,48863,17425,65289,48208,17081
27/09/2017,69897,48032,17072,64077,47363,16714
28/09/2017,70883,48746,16948,64535,48025,16510
29/09/2017,67177,45558,15661,60017,44801,15216
30/09/2017,50153,29980,12367,40772,29036,11736
01/10/2017,55505,31911,13977,43919,30740,13179
02/10/2017,65511,44829,15347,59122,44165,14957
03/10/2017,69105,47735,16541,63364,47166,16198
04/10/2017,71454,48989,17104,65154,48364,16790
05/10/2017,70174,48201,16647,63852,47565,16287
06/10/2017,70257,47217,16194,62168,46416,15752
07/10/2017,63635,35097,14631,47164,33519,13645
08/10/2017,41044,24520,9301,32703,23809,8894
09/10/2017,38391,27038,8669,35208,26724,8484
10/10/2017,74118,49949,17243,66148,49272,16876
11/10/2017,63589,44096,14755,58201,43660,14541
12/10/2017,61248,42978,13861,56132,42528,13604
13/10/2017,67020,45905,15247,60139,45234,14905
14/10/2017,58777,33963,14163,46252,32799,13453
15/10/2017,56529,32584,13306,43900,31411,12489
16/10/2017,61730,42904,14132,56295,42414,13881
17/10/2017,64480,44779,15194,59265,44281,14984
18/10/2017,70234,48393,16693,64215,47804,16411
19/10/2017,72311,49554,16888,65333,48888,16445
20/10/2017,72173,47994,16736,63436,47211,16225
21/10/2017,65874,36251,15713,49491,34801,14690
22/10/2017,62150,33911,14648,45878,32289,13589
23/10/2017,69274,46409,15834,61077,45656,15421
24/10/2017,48077,34666,10748,45072,34421,10651
25/10/2017,71287,49612,16563,65383,49065,16318
26/10/2017,64003,45263,14584,59077,44732,14345
27/10/2017,69268,47167,15588,61331,46271,15060
28/10/2017,61348,35075,14829,47244,33420,13824
29/10/2017,9537,6624,2066,8552,6524,2028
30/10/2017,49247,35038,11145,45585,34670,10915
31/10/2017,60242,42694,13458,55430,42200,13230
01/11/2017,60773,43582,13637,56613,43180,13433
02/11/2017,70810,49003,16100,64047,48292,15755
03/11/2017,71818,48187,15984,62652,47111,15541
04/11/2017,53435,31632,12965,42480,30328,12152
05/11/2017,34943,22875,8340,30311,22265,8046
06/11/2017,57606,40765,13011,53080,40287,12793
07/11/2017,36362,25617,8257,33417,25335,8082
08/11/2017,54211,39238,12213,51062,38973,12089
09/11/2017,58417,41753,13403,54543,41380,13163
10/11/2017,38432,28167,8474,36217,27884,8333
11/11/2017,28142,19009,6914,25285,18603,6682
12/11/2017,32471,21094,8142,28360,20558,7802
13/11/2017,38753,28759,8483,36976,28561,8415
14/11/2017,52279,37949,12046,49590,37696,11894
15/11/2017,54230,39371,12443,51382,39057,12325
16/11/2017,49737,36153,11292,47078,35901,11177
17/11/2017,48991,35136,11062,45575,34770,10805
18/11/2017,27745,18703,6691,24823,18324,6499
19/11/2017,31598,20901,7857,28076,20456,7620
20/11/2017,45121,33091,9994,42685,32810,9875
21/11/2017,52451,37676,11664,48816,37366,11450
22/11/2017,32298,23583,7007,30301,23396,6905
23/11/2017,13705,8398,3043,11017,8124,2893
24/11/2017,23724,15325,5189,19823,14901,4922
25/11/2017,30518,18192,6829,23751,17362,6389
26/11/2017,27181,17700,6382,23384,17258,6126
27/11/2017,46733,34058,10373,44032,33772,10260
28/11/2017,51170,37317,11750,48741,37093,11648
29/11/2017,55295,40027,12748,52366,39732,12634
30/11/2017,51700,37466,11907,49011,37227,11784
01/12/2017,50708,36723,11385,47572,36350,11222
02/12/2017,38923,25177,9708,33991,24599,9392
03/12/2017,33728,22175,8437,29926,21765,8161
04/12/2017,49630,35912,11159,46626,35629,10997
05/12/2017,41792,30448,9485,39712,30284,9428
06/12/2017,46335,34225,10367,44296,34018,10278
07/12/2017,45367,33545,9977,43234,33348,9886
08/12/2017,41330,30604,9023,39320,30424,8896
09/12/2017,10804,8056,2262,10239,7997,2242
10/12/2017,19815,13965,4756,18565,13890,4675
11/12/2017,41838,30862,9380,39989,30714,9275
12/12/2017,42620,31745,9402,40988,31648,9340
13/12/2017,32623,24802,6852,31565,24731,6834
14/12/2017,27495,21195,5526,26645,21164,5481
15/12/2017,22944,17698,4576,22234,17668,4566
16/12/2017,19060,13916,4269,18047,13831,4216
17/12/2017,22403,15818,5458,21084,15703,5381
18/12/2017,40168,30123,8462,38357,29952,8405
19/12/2017,49503,36657,10796,47054,36406,10648
20/12/2017,41463,31155,8695,39568,30942,8626
21/12/2017,37592,28281,7702,35703,28094,7609
22/12/2017,34341,25342,7165,32198,25156,7042
23/12/2017,9608,7168,2012,9125,7142,1983
24/12/2017,13216,8752,3029,11598,8658,2940
25/12/2017,6479,4090,1316,5234,3989,1245
26/12/2017,14113,10374,2831,13091,10309,2782
27/12/2017,16365,12309,3212,15407,12248,3159
28/12/2017,13420,10412,2479,12807,10361,2446
29/12/2017,13759,10573,2587,13082,10514,2568
30/12/2017,5956,4569,1115,5655,4550,1105
31/12/2017,6569,4877,1379,6215,4844,1371
01/01/2018,5500,4073,1112,5133,4047,1086
02/01/2018,18818,14792,3441,18178,14749,3429
03/01/2018,24299,18840,4705,23470,18790,4680
04/01/2018,1922,1661,218,1874,1656,218
05/01/2018,4972,4114,724,4831,4109,722
06/01/2018,4295,3408,775,4180,3405,775
07/01/2018,5640,4391,1096,5455,4367,1088
08/01/2018,15821,12729,2769,15431,12677,2754
09/01/2018,25091,19587,4888,24406,19539,4867
10/01/2018,28252,21871,5586,27368,21811,5557
11/01/2018,33961,25766,6976,32621,25691,6930
12/01/2018,22254,17071,4419,21398,17026,4372
13/01/2018,17760,12492,4206,16538,12397,4141
14/01/2018,12399,8897,2837,11602,8811,2791
15/01/2018,17637,13194,3797,16863,13114,3749
16/01/2018,30278,23157,6250,29277,23050,6227
17/01/2018,19010,14904,3667,18534,14886,3648
18/01/2018,27662,21366,5629,26880,21299,5581
19/01/2018,30525,23315,6247,29400,23205,6195
20/01/2018,28507,19107,6917,25525,18814,6711
21/01/2018,27908,18442,6842,24747,18142,6605
22/01/2018,36865,27409,7982,35194,27293,7901
23/01/2018,28797,21740,6248,27864,21665,6199
24/01/2018,36078,27209,7631,34691,27123,7568
25/01/2018,31147,23782,6376,30010,23684,6326
26/01/2018,33073,24947,6888,31617,24798,6819
27/01/2018,34351,22294,8671,30106,21847,8259
28/01/2018,20101,14122,4737,18623,13992,4631
29/01/2018,36799,27545,7883,35198,27441,7757
30/01/2018,27996,21393,5800,27085,21351,5734
31/01/2018,31276,23971,6489,30329,23904,6425
01/02/2018,35561,26922,7526,34294,26828,7466
02/02/2018,26313,20344,5236,25447,20266,5181
03/02/2018,18385,13245,4307,17291,13074,4217
04/02/2018,13959,9974,3378,13198,9872,3326
05/02/2018,29068,22088,6053,28039,22029,6010
06/02/2018,34102,26021,7130,33041,25959,7082
07/02/2018,15289,12192,2769,14932,12164,2768
08/02/2018,31564,24246,6453,30511,24101,6410
09/02/2018,31567,24170,6400,30369,24023,6346
10/02/2018,16324,11461,3935,15201,11348,3853
11/02/2018,8809,6658,1799,8357,6597,1760
12/02/2018,35139,26526,7183,33471,26377,7094
13/02/2018,35189,26616,7276,33676,26472,7204
14/02/2018,39591,29637,8389,37747,29467,8280
15/02/2018,44193,32627,9697,42034,32443,9591
16/02/2018,29191,22066,5867,27696,21907,5789
17/02/2018,17921,12152,4276,16124,11967,4157
18/02/2018,21538,14091,5050,18514,13763,4751
19/02/2018,25677,18182,5755,23535,17952,5583
20/02/2018,44480,32198,9542,41154,31829,9325
21/02/2018,53115,37153,11704,47910,36598,11312
22/02/2018,27010,20617,5464,25952,20522,5430
23/02/2018,25634,19713,5134,24670,19579,5091
24/02/2018,25550,17257,6001,22702,16927,5775
25/02/2018,16150,11854,3502,15207,11746,3461
26/02/2018,42570,31472,9262,40466,31326,9140
27/02/2018,48516,35355,10765,45707,35111,10596
28/02/2018,50709,36912,11413,47915,36693,11222
01/03/2018,45564,33411,9992,42972,33178,9794
02/03/2018,6855,5612,1073,6650,5587,1063
03/03/2018,28364,19435,6762,25649,19145,6504
04/03/2018,25262,17106,6060,22765,16890,5875
05/03/2018,36774,27366,7806,34947,27228,7719
06/03/2018,42689,31582,9146,40444,31415,9029
07/03/2018,8188,6461,1539,7974,6441,1533
08/03/2018,28440,21804,5730,27382,21717,5665
09/03/2018,34912,26198,7423,33424,26091,7333
10/03/2018,25444,17475,6139,23028,17107,5921
11/03/2018,27597,17792,6835,23885,17427,6458
12/03/2018,36340,27053,7791,34453,26838,7615
13/03/2018,23137,17774,4670,22323,17705,4618
14/03/2018,35377,26834,7344,33908,26658,7250
15/03/2018,39574,29401,8527,37557,29179,8378
16/03/2018,34921,26208,7107,32951,26016,6935
17/03/2018,27672,18478,6739,24409,18046,6363
18/03/2018,25158,16862,5911,22075,16487,5588
19/03/2018,39278,28598,8553,36680,28353,8327
20/03/2018,35532,26837,7457,34115,26745,7370
21/03/2018,3755,3070,606,3660,3056,604
22/03/2018,27308,20808,5559,26219,20711,5508
23/03/2018,38528,28623,8092,36343,28404,7939
24/03/2018,34398,22223,8190,29439,21632,7807
25/03/2018,25562,17239,6264,22868,16869,5999
26/03/2018,40295,29437,8654,37465,29081,8384
27/03/2018,41354,30515,8941,38933,30193,8740
28/03/2018,42520,31365,9025,39910,31055,8855
29/03/2018,39293,29107,8138,36858,28849,8009
30/03/2018,34787,24762,7170,31210,24289,6921
31/03/2018,41794,23097,9444,30305,21824,8481
01/04/2018,33149,18746,7231,24505,17899,6606
02/04/2018,22063,16501,4337,20677,16386,4291
03/04/2018,25881,19846,5177,24871,19713,5158
04/04/2018,36753,27504,7417,34636,27310,7326
05/04/2018,39814,29084,7898,36478,28728,7750
06/04/2018,35624,26036,7410,32980,25723,7257
07/04/2018,33245,21621,7818,28430,20987,7443
08/04/2018,28410,18749,6801,24771,18275,6496
09/04/2018,40509,29718,8748,38050,29459,8591
10/04/2018,43051,31870,9573,41090,31639,9451
11/04/2018,48612,35311,10713,45337,34866,10471
12/04/2018,53168,38472,11664,49315,37917,11398
13/04/2018,63510,42932,14051,54997,41721,13276
14/04/2018,62597,33752,14834,43937,31107,12830
15/04/2018,20440,13778,4980,18290,13483,4807
16/04/2018,26289,19498,5565,24754,19271,5483
17/04/2018,44689,32970,9755,42210,32620,9590
18/04/2018,51110,37128,11169,47446,36544,10902
19/04/2018,38298,28730,8149,36498,28445,8053
20/04/2018,47052,33798,10070,43042,33282,9760
21/04/2018,63599,36790,18321,41370,29465,11905
22/04/2018,54284,30724,13555,39620,28059,11561
23/04/2018,57767,39993,12939,51296,39008,12288
24/04/2018,58527,41277,13342,53310,40447,12863
25/04/2018,31214,23407,6636,29708,23166,6542
26/04/2018,66077,45233,15037,58460,44129,14331
27/04/2018,39154,28993,7951,36228,28490,7738
28/04/2018,56745,31571,13457,41081,29306,11775
29/04/2018,44837,26186,10624,34073,24595,9478
30/04/2018,41075,29966,8608,37819,29464,8355
01/05/2018,72035,48310,16568,62465,46839,15626
02/05/2018,76773,51519,17756,66853,50038,16815
03/05/2018,69056,46910,15683,60212,45390,14822
04/05/2018,71199,47082,15885,60223,45337,14886
05/05/2018,63329,35468,14916,45721,32667,13054
06/05/2018,48993,29219,11650,38092,27495,10597
07/05/2018,68917,46061,15555,59152,44532,14620
08/05/2018,74313,49634,17158,64382,48142,16240
09/05/2018,78458,53048,18196,68825,51530,17295
10/05/2018,67455,46175,15450,59434,44757,14677
11/05/2018,75266,49086,16849,62603,47020,15583
12/05/2018,34535,21820,8009,28041,20711,7330
13/05/2018,25986,17004,6071,22065,16392,5673
14/05/2018,64729,43885,14990,56816,42625,14191
15/05/2018,52826,36407,12002,46809,35356,11453
16/05/2018,32766,24018,7338,30863,23683,7180
17/05/2018,49789,35449,10924,45138,34607,10531
18/05/2018,63113,43859,13910,55569,42437,13132
19/05/2018,18026,12960,3673,16062,12495,3567
20/05/2018,56949,32668,13856,42830,30470,12360
21/05/2018,71220,46778,16638,60516,44962,15554
22/05/2018,48508,34805,10936,44729,34101,10628
23/05/2018,72655,49576,17120,64309,48091,16218
24/05/2018,74810,50227,17582,65016,48537,16479
25/05/2018,69345,44623,16228,57379,42550,14829
26/05/2018,51597,27640,12037,34361,24475,9886
27/05/2018,25814,16134,5928,20199,14919,5280
28/05/2018,49043,27433,11944,35282,25113,10169
29/05/2018,69090,46580,16546,60753,45127,15626
30/05/2018,72321,49336,17203,64162,47766,16396
31/05/2018,55794,40102,12703,51389,39146,12243
01/06/2018,62877,42706,14242,54541,41134,13407
02/06/2018,60293,34939,14934,45748,32524,13224
03/06/2018,50045,29953,12326,39128,28058,11070
04/06/2018,58913,40193,13931,52257,39005,13252
05/06/2018,71912,49401,17390,64768,48161,16607
06/06/2018,69802,48443,16579,62997,47177,15820
07/06/2018,70483,48535,16549,62823,47154,15669
08/06/2018,72711,48235,17364,62486,46324,16162
09/06/2018,65250,36702,16600,47908,33622,14286
10/06/2018,41642,25477,9842,32650,23824,8826
11/06/2018,68078,46109,16116,59793,44593,15200
12/06/2018,76279,51833,18288,67532,50243,17289
13/06/2018,64292,45222,15150,58692,44115,14577
14/06/2018,75807,51957,17873,67040,50165,16875
15/06/2018,72422,48397,17039,62083,46298,15785
16/06/2018,63187,35796,15791,46006,32539,13467
17/06/2018,56228,31886,14134,41302,29111,12191
18/06/2018,63557,43244,14968,55954,41819,14135
19/06/2018,72170,49471,17576,64605,47941,16664
20/06/2018,74090,50704,18110,66090,48933,17157
21/06/2018,70052,47659,16793,61839,45949,15890
22/06/2018,71086,47829,16511,61232,45806,15426
23/06/2018,51031,31384,12686,40585,29154,11431
24/06/2018,55775,31828,14135,41458,29179,12279
25/06/2018,71752,48096,17142,62469,46383,16086
26/06/2018,80651,54784,19697,71655,53047,18608
27/06/2018,67698,47291,15900,60995,45882,15113
28/06/2018,50433,35373,11550,45183,34231,10952
29/06/2018,69864,46798,16453,60122,44843,15279
30/06/2018,54723,31663,13875,41119,29041,12078
01/07/2018,45266,26411,11259,34125,24298,9827
02/07/2018,58635,39859,13559,50972,38364,12608
03/07/2018,54884,37401,12923,48079,35952,12127
04/07/2018,48372,27169,11851,34456,24540,9916
05/07/2018,59476,39509,13784,50134,37513,12621
06/07/2018,49507,33662,11375,42684,32153,10531
07/07/2018,60918,33628,15498,42604,29937,12667
08/07/2018,60489,33542,15020,43073,30210,12863
09/07/2018,70067,47452,16838,61486,45685,15801
10/07/2018,72509,49910,17496,64855,48259,16596
11/07/2018,73018,50088,17703,65273,48526,16747
12/07/2018,74860,51030,18061,66147,49155,16992
13/07/2018,72121,48461,17139,62258,46348,15910
14/07/2018,62565,35669,15591,45375,32113,13262
15/07/2018,52295,30622,13318,39695,28110,11585
16/07/2018,67073,45354,15985,58562,43603,14959
17/07/2018,48497,34172,11139,44077,33386,10691
18/07/2018,75708,51734,18267,66990,49838,17152
19/07/2018,77993,53103,18630,68628,51103,17525
20/07/2018,74542,49351,17740,63454,47049,16405
21/07/2018,53655,30552,13579,39041,27540,11501
22/07/2018,44285,25972,11340,33911,24031,9880
23/07/2018,53077,36792,12177,47093,35555,11538
24/07/2018,69755,48301,16674,62361,46559,15802
25/07/2018,42990,30781,9386,38887,29886,9001
26/07/2018,71046,48792,16889,62691,46851,15840
27/07/2018,49221,33218,11338,42368,31869,10499
28/07/2018,61547,35175,15471,44462,31498,12964
29/07/2018,63480,36170,15683,45817,32596,13221
30/07/2018,69497,46706,16256,59818,44710,15108
31/07/2018,76277,51960,18310,67158,49979,17179
01/08/2018,64462,44853,15153,57805,43435,14370
02/08/2018,69705,47661,16465,61667,46032,15635
03/08/2018,61958,41939,14469,53895,40304,13591
04/08/2018,51200,29876,12399,38415,27445,10970
05/08/2018,58381,32565,14513,42162,29607,12555
06/08/2018,65677,43629,15575,56813,42149,14664
07/08/2018,64346,43868,15360,57008,42458,14550
08/08/2018,70573,47844,16863,62499,46429,16070
09/08/2018,71942,48686,17337,63336,47002,16334
10/08/2018,69599,45766,16528,58945,43720,15225
11/08/2018,36607,22618,8798,28931,21049,7882
12/08/2018,59835,34251,15192,44381,31290,13091
13/08/2018,44251,31581,9996,40153,30578,9575
14/08/2018,63686,44164,14778,56640,42634,14006
15/08/2018,73112,49447,17664,64063,47514,16549
16/08/2018,70806,47925,16839,61575,45869,15706
17/08/2018,63303,42405,15039,54406,40415,13991
18/08/2018,57278,31457,14851,40676,28249,12427
19/08/2018,45870,27921,11578,35813,25611,10202
20/08/2018,67565,45529,15955,58649,43793,14856
21/08/2018,75184,50651,17963,65423,48542,16881
22/08/2018,72602,49497,17461,63931,47557,16374
23/08/2018,73828,49923,17545,63913,47605,16308
24/08/2018,72880,48073,17273,60915,45246,15669
25/08/2018,64685,35966,16343,45753,32081,13672
26/08/2018,60953,34598,15176,43707,31067,12640
27/08/2018,67622,45936,15975,58833,43944,14889
28/08/2018,66609,45625,16194,59216,43925,15291
29/08/2018,65887,45274,15987,58729,43632,15097
30/08/2018,67877,46688,16243,60101,44911,15190
31/08/2018,58894,40096,13973,50988,37967,13021
01/09/2018,54323,30279,13375,37896,26793,11103
02/09/2018,60812,32843,16141,35432,25117,10315
03/09/2018,55052,31261,13854,38350,27352,10998
04/09/2018,68628,47090,16295,60659,45377,15282
05/09/2018,74963,51712,18181,67323,50036,17287
06/09/2018,70244,48857,16856,63241,47184,16057
07/09/2018,74582,51451,17652,66167,49433,16734
08/09/2018,58286,35543,14952,45589,32471,13118
09/09/2018,19950,13824,4715,17613,13157,4456
10/09/2018,23944,18068,5043,22611,17681,4930
11/09/2018,66536,46840,15847,60590,45431,15159
12/09/2018,53216,37722,12576,48739,36647,12092
13/09/2018,74038,51877,17713,66846,50001,16845
14/09/2018,74320,50795,17643,65051,48537,16514
15/09/2018,71190,41753,18932,53712,37634,16078
16/09/2018,69526,40413,18493,51956,36289,15667
17/09/2018,71330,49269,17190,63290,47231,16059
18/09/2018,53069,38026,12851,49507,37062,12445
19/09/2018,74360,50779,18408,65766,48563,17203
20/09/2018,76790,53244,18701,68883,51261,17622
21/09/2018,74934,51872,17963,66241,49526,16715
22/09/2018,69130,41216,18395,53027,37367,15660
23/09/2018,55493,34430,14498,44611,31812,12799
24/09/2018,71620,50146,17343,64494,48159,16335
25/09/2018,25421,18959,5530,23761,18407,5354
26/09/2018,67994,47999,16561,61759,46119,15640
27/09/2018,75358,52531,18068,67057,50211,16846
28/09/2018,57215,40734,13496,51453,38887,12566
29/09/2018,69327,41789,18491,52467,37055,15412
30/09/2018,66233,39642,17670,49657,35097,14560
01/10/2018,71378,49518,17133,62901,47131,15770
02/10/2018,73110,51034,18044,65705,48827,16878
03/10/2018,76757,53511,18981,69097,51270,17827
04/10/2018,70657,49735,16743,63312,47629,15683
05/10/2018,74515,51808,17585,65187,48944,16243
06/10/2018,57311,35855,14479,44394,32049,12345
07/10/2018,60525,36047,15633,44940,32044,12896
08/10/2018,57889,40192,13436,50287,38028,12259
09/10/2018,73713,51875,17652,66544,49949,16595
10/10/2018,76756,53508,18549,68867,51359,17508
11/10/2018,46530,33827,10514,43024,32870,10154
12/10/2018,67009,47344,15154,59333,45278,14055
13/10/2018,54328,35105,14642,39143,28765,10378
14/10/2018,53824,33604,13826,42232,30512,11720
15/10/2018,58399,42140,13468,53588,40719,12869
16/10/2018,65751,46917,15609,60102,45281,14821
17/10/2018,66902,47869,15654,61067,46150,14917
18/10/2018,60825,43738,13984,55700,42341,13359
19/10/2018,63988,44967,14728,56620,42884,13736
20/10/2018,55763,35032,13995,43998,31864,12134
21/10/2018,38760,25716,9594,32759,24075,8684
22/10/2018,57111,41116,13216,52452,39818,12634
23/10/2018,67210,48030,15692,61285,46381,14904
24/10/2018,63306,45591,14679,58205,44167,14038
25/10/2018,60762,43806,13878,55639,42367,13272
26/10/2018,59134,42449,13468,53458,40693,12765
27/10/2018,13000,9861,2622,12025,9505,2520
28/10/2018,42098,27342,10832,35396,25587,9809
29/10/2018,59205,42566,13750,54486,41373,13113
30/10/2018,64653,46277,15292,59631,44955,14676
31/10/2018,67488,47850,15953,61435,46238,15197
01/11/2018,73175,51048,17149,65193,49071,16122
02/11/2018,62925,44365,14428,56028,42511,13517
03/11/2018,48612,31422,12048,39412,28847,10565
04/11/2018,50230,31656,12945,39855,28642,11213
05/11/2018,32884,24903,6868,30862,24246,6616
06/11/2018,39672,29948,8599,36860,28708,8152
07/11/2018,67031,47747,15711,60569,45816,14753
08/11/2018,63476,45520,14845,57967,43949,14018
09/11/2018,36441,26611,8237,33661,25796,7865
10/11/2018,37464,25012,9298,31741,23333,8408
11/11/2018,36222,23909,9154,30614,22343,8271
12/11/2018,50568,36672,11493,46400,35516,10884
13/11/2018,36389,27457,7902,34563,26856,7707
14/11/2018,48923,36435,11042,46441,35695,10746
15/11/2018,24738,18693,5448,23695,18351,5344
16/11/2018,34171,25964,7029,32263,25425,6838
17/11/2018,37773,25763,9362,32919,24248,8671
18/11/2018,34190,23560,8394,30097,22317,7780
19/11/2018,53950,39589,12145,50142,38523,11619
20/11/2018,51177,37938,11463,48016,36983,11033
21/11/2018,39930,29470,8819,37190,28672,8518
22/11/2018,8718,6296,1927,7848,6035,1813
23/11/2018,15931,11533,3535,14519,11172,3347
24/11/2018,19859,13613,4710,17047,12731,4316
25/11/2018,34191,22363,8611,28689,20929,7760
26/11/2018,28819,21530,6349,27290,21104,6186
27/11/2018,49201,36646,11070,46866,36012,10854
28/11/2018,47662,35775,10564,45492,35121,10371
29/11/2018,50644,37607,11246,47855,36873,10982
30/11/2018,45389,33824,9977,42612,32958,9654
01/12/2018,37561,25556,9257,32866,24245,8621
02/12/2018,18203,13436,4034,16952,13080,3872
03/12/2018,53153,39114,12113,49908,38174,11734
04/12/2018,48285,36091,10772,46031,35490,10541
05/12/2018,46036,34423,10201,43765,33771,9994
06/12/2018,45867,34304,10050,43432,33629,9803
07/12/2018,43270,32474,9235,40754,31763,8991
08/12/2018,29555,20838,7272,26801,19958,6843
09/12/2018,27224,19114,6667,24730,18400,6330
10/12/2018,42726,32151,9156,40495,31563,8932
11/12/2018,46610,34997,10173,44312,34358,9954
12/12/2018,47036,35487,10183,44853,34873,9980
13/12/2018,40203,30619,8558,38556,30124,8432
14/12/2018,44190,32945,9556,41248,32027,9221
15/12/2018,35981,25185,8632,31955,23925,8030
16/12/2018,9746,7449,1979,9165,7226,1939
17/12/2018,44694,33791,9545,42318,33082,9236
18/12/2018,41152,31483,8586,39313,30895,8418
19/12/2018,43464,33035,9177,41289,32289,9000
20/12/2018,33580,25480,7035,31793,24895,6898
21/12/2018,23696,18343,4651,22407,17823,4584
22/12/2018,24628,17549,5689,22073,16701,5372
23/12/2018,21995,15059,5173,18948,14155,4793
24/12/2018,18741,13771,4102,17102,13196,3906
25/12/2018,11084,7060,2416,8512,6411,2101
26/12/2018,25145,18462,5089,22298,17574,4724
27/12/2018,30879,22353,6319,27239,21352,5887
28/12/2018,11921,9249,2204,10996,8855,2141
29/12/2018,28788,18565,6647,22571,16822,5749
30/12/2018,22329,14960,5183,18539,13885,4654
31/12/2018,18763,13279,4021,16401,12635,3766
01/01/2019,21962,13804,5133,16917,12540,4377
02/01/2019,37797,27937,7825,34694,27172,7522
03/01/2019,41676,31237,8903,39192,30553,8639
04/01/2019,43922,32615,9502,40839,31749,9090
05/01/2019,17432,13049,3785,16325,12639,3686
06/01/2019,31451,21819,7763,27757,20585,7172
07/01/2019,36486,27897,7611,34839,27375,7464
08/01/2019,41163,31234,8864,39387,30683,8704
09/01/2019,44338,33547,9650,42373,32907,9466
10/01/2019,38971,30182,7906,37428,29647,7781
11/01/2019,32805,25498,6508,31347,24958,6389
12/01/2019,25131,18229,5855,23225,17551,5674
13/01/2019,22752,16534,5356,21082,15948,5134
14/01/2019,34970,26783,7304,33670,26465,7205
15/01/2019,39068,29692,8398,37475,29220,8255
16/01/2019,40349,30938,8424,38828,30502,8326
17/01/2019,38956,29944,8020,37467,29542,7925
18/01/2019,34227,26344,6942,32613,25825,6788
19/01/2019,23748,16864,5632,21665,16292,5373
20/01/2019,14249,10484,3212,13248,10132,3116
21/01/2019,10291,8152,1845,9821,8000,1821
22/01/2019,28562,22133,5703,27460,21830,5630
23/01/2019,41483,31702,8719,39824,31204,8620
24/01/2019,20081,15738,3856,19287,15476,3811
25/01/2019,38813,29756,7920,37074,29275,7799
26/01/2019,26298,18861,6091,24094,18225,5869
27/01/2019,30021,20708,7292,26875,19896,6979
28/01/2019,35584,27015,7554,34123,26655,7468
29/01/2019,30928,23763,6352,29708,23428,6280
30/01/2019,25142,19711,4804,24251,19498,4753
31/01/2019,18631,14960,3299,18015,14746,3269
01/02/2019,24982,19692,4712,24058,19378,4680
02/02/2019,22002,16186,4923,20468,15658,4810
03/02/2019,31934,22248,7754,28531,21222,7309
04/02/2019,46376,34232,10261,43261,33396,9865
05/02/2019,54161,39492,12256,50090,38376,11714
06/02/2019,39215,29429,8485,37046,28790,8256
07/02/2019,43177,32646,9200,41036,32057,8979
08/02/2019,36454,27879,7378,34296,27139,7157
09/02/2019,23765,17201,5566,21853,16531,5322
10/02/2019,24131,17205,5723,22048,16560,5488
11/02/2019,38636,29363,8170,36920,28918,8002
12/02/2019,15854,12488,3024,15305,12312,2993
13/02/2019,34941,27166,6937,33550,26729,6821
14/02/2019,41650,31468,8836,39495,30850,8645
15/02/2019,46863,34932,9990,43356,33777,9579
16/02/2019,31034,21002,7434,26475,19653,6822
17/02/2019,24037,16385,5714,20616,15366,5250
18/02/2019,25827,18896,5784,23791,18279,5512
19/02/2019,34676,26520,7144,32919,25979,6940
20/02/2019,20426,15946,3959,19575,15674,3901
21/02/2019,39499,29837,8149,36970,29117,7853
22/02/2019,41794,31329,8773,38881,30396,8485
23/02/2019,31608,22138,7614,28039,20886,7153
24/02/2019,24272,17297,5754,21984,16548,5436
25/02/2019,34216,26282,6914,32595,25842,6753
26/02/2019,37516,28801,7692,35877,28301,7576
27/02/2019,36475,28088,7516,35048,27665,7383
28/02/2019,38223,29316,7850,36426,28736,7690
01/03/2019,30233,23421,5868,28659,22929,5730
02/03/2019,18001,13375,3793,16521,12879,3642
03/03/2019,23239,16218,5653,20945,15613,5332
04/03/2019,28421,21723,5582,26751,21322,5429
05/03/2019,37097,28349,7612,35293,27863,7430
06/03/2019,33279,25786,6611,31940,25441,6499
07/03/2019,35907,27750,7198,34394,27329,7065
08/03/2019,40406,30948,8104,38138,30256,7882
09/03/2019,38928,26479,9385,33178,24695,8483
10/03/2019,18897,14040,4092,17457,13534,3923
11/03/2019,52413,38744,11323,48305,37595,10710
12/03/2019,47207,35630,9966,44514,34878,9636
13/03/2019,50120,37556,10644,47016,36672,10344
14/03/2019,57466,42737,12299,53187,41469,11718
15/03/2019,57506,41665,12651,51634,39854,11780
16/03/2019,42138,28088,10235,35054,25922,9132
17/03/2019,36824,24604,9239,30809,22599,8210
18/03/2019,46532,34464,10114,42917,33307,9610
19/03/2019,52981,39049,11559,49012,37946,11066
20/03/2019,55379,40765,12156,51190,39565,11625
21/03/2019,21238,16785,3902,20265,16431,3834
22/03/2019,35463,26959,7208,33078,26162,6916
23/03/2019,37375,25711,8864,32200,24155,8045
24/03/2019,50312,31890,12880,39434,28741,10693
25/03/2019,53451,39268,11807,49193,37953,11240
26/03/2019,55414,40848,12332,51289,39558,11731
27/03/2019,54473,40185,12045,50621,39069,11552
28/03/2019,58529,42974,12924,53872,41597,12275
29/03/2019,59307,43171,13066,53573,41361,12212
30/03/2019,66662,40803,16954,49694,35954,13740
31/03/2019,32762,22618,7714,28215,21138,7077
01/04/2019,51391,38217,11107,47655,37036,10619
02/04/2019,57891,42981,12822,54182,41821,12361
03/04/2019,67911,49332,15221,61718,47447,14271
04/04/2019,66396,48480,14715,60481,46666,13815
05/04/2019,34459,26263,7074,32367,25525,6842
06/04/2019,66529,40363,16603,49881,36015,13866
07/04/2019,64709,39692,16425,48784,35240,13544
08/04/2019,70500,49835,16171,62475,47499,14976
09/04/2019,59327,43782,13056,55028,42496,12532
10/04/2019,70977,51171,16344,64534,49217,15317
11/04/2019,62414,45698,13855,57157,44075,13082
12/04/2019,57998,41959,12602,51647,39975,11672
13/04/2019,71492,42861,18533,52568,37609,14959
14/04/2019,58470,35644,15306,44138,31494,12644
15/04/2019,45654,33475,9961,41492,32101,9391
16/04/2019,63316,44765,14695,56223,42670,13553
17/04/2019,65238,46030,15055,57854,43931,13923
18/04/2019,61555,44326,13724,55258,42439,12819
19/04/2019,64933,43147,15083,52707,39623,13084
20/04/2019,36784,23476,8787,28487,21063,7424
21/04/2019,51865,30083,12710,36044,26075,9969
22/04/2019,44109,31490,9991,36309,28110,8199
23/04/2019,75434,50842,17694,62408,47009,15399
24/04/2019,77723,52662,18189,65260,49161,16099
25/04/2019,60821,42618,13490,52414,40316,12098
26/04/2019,37115,27756,7608,33831,26667,7164
27/04/2019,56434,35334,14154,42588,30972,11616
28/04/2019,41200,27848,9916,34351,25548,8803
29/04/2019,60789,43258,13940,54052,41277,12775
30/04/2019,62660,45163,14454,56800,43250,13550
01/05/2019,60897,44482,13604,55540,42711,12829
02/05/2019,68701,48317,15963,60510,45819,14691
03/05/2019,62405,44373,14259,54775,41810,12965
04/05/2019,56023,34596,14103,41937,30406,11531
05/05/2019,16169,11593,3639,14319,10935,3384
06/05/2019,69914,48764,16448,60887,45988,14899
07/05/2019,72824,50937,17475,64256,48238,16018
08/05/2019,76389,53621,18283,67370,50706,16664
09/05/2019,66681,48161,15419,60300,45939,14361
10/05/2019,68039,48099,15813,59206,44985,14221
11/05/2019,69788,41229,18458,48886,34830,14056
12/05/2019,10729,8056,2119,9578,7611,1967
13/05/2019,22296,17228,4457,20988,16677,4311
14/05/2019,42780,31890,9458,39930,30869,9061
15/05/2019,74307,52256,17567,65520,49440,16080
16/05/2019,77878,53822,18916,67351,50364,16987
17/05/2019,72112,49843,16916,62114,46681,15433
18/05/2019,73143,42823,18467,51753,36976,14777
19/05/2019,69920,40205,18000,49101,34963,14138
20/05/2019,74489,50591,18183,63688,47414,16274
21/05/2019,79254,54673,19382,68863,51443,17420
22/05/2019,82007,56246,20242,71243,52882,18361
23/05/2019,56575,39808,13203,49676,37620,12056
24/05/2019,74857,49791,18102,61131,45518,15613
25/05/2019,59492,33031,15561,38358,27109,11249
26/05/2019,49950,27573,12635,31242,22394,8848
27/05/2019,66595,36980,16987,43119,30767,12352
28/05/2019,59432,42269,14081,53539,40371,13168
29/05/2019,55089,39163,12891,49191,37334,11857
30/05/2019,52481,37590,11879,46738,35741,10997
31/05/2019,83347,55769,20103,68935,51319,17616
01/06/2019,76419,45072,19799,53472,38127,15345
02/06/2019,67298,39953,17946,48356,34184,14172
03/06/2019,77694,53243,18897,66360,49566,16794
04/06/2019,83299,56773,20737,71610,53161,18449
05/06/2019,78805,54708,19506,69283,51579,17704
06/06/2019,81356,55931,19860,70011,52188,17823
07/06/2019,82950,55686,20565,68699,50891,17808
08/06/2019,78096,45281,20375,53256,37710,15546
09/06/2019,73972,42687,19904,51045,35971,15074
10/06/2019,37024,27443,8077,34050,26433,7617
11/06/2019,78052,54073,19155,67949,50641,17308
12/06/2019,85042,58429,21202,73705,54680,19025
13/06/2019,49195,35207,11304,43935,33483,10452
14/06/2019,80613,54752,19648,67987,50630,17357
15/06/2019,73899,43477,19180,50867,36213,14654
16/06/2019,55523,33984,14511,41477,29758,11719
17/06/2019,72530,50095,17433,62715,47100,15615
18/06/2019,36402,26635,7992,32943,25411,7532
19/06/2019,63674,45806,14483,56848,43401,13447
20/06/2019,59926,43004,13875,53475,40727,12748
21/06/2019,65686,45145,15503,55436,41693,13743
22/06/2019,76612,44928,20203,53054,37635,15419
23/06/2019,75546,43884,20113,52237,37011,15226
24/06/2019,80028,54755,19380,68163,50818,17345
25/06/2019,65885,46025,15910,57728,43253,14475
26/06/2019,83301,57332,20269,71608,53291,18317
27/06/2019,81577,55941,19711,69307,51802,17505
28/06/2019,78682,53155,18867,64962,48441,16521
29/06/2019,62714,37993,16435,45586,32487,13099
30/06/2019,63570,37711,16737,44709,31752,12957
01/07/2019,78238,52961,19214,65463,48693,16770
02/07/2019,78158,53534,19147,66801,49750,17051
03/07/2019,74223,49855,18236,62087,45927,16160
04/07/2019,52712,29636,13950,33908,23860,10048
05/07/2019,58723,36108,14488,41898,30840,11058
06/07/2019,50897,29673,13180,34211,24398,9813
07/07/2019,61485,36071,16474,42855,30328,12527
08/07/2019,68030,46814,16415,57943,43391,14552
09/07/2019,83708,57170,20992,72098,53205,18893
10/07/2019,84219,57705,20991,72455,53679,18776
11/07/2019,54495,38387,12959,47892,36086,11806
12/07/2019,81075,55063,19790,67611,50429,17182
13/07/2019,76860,45713,20183,53503,37939,15564
14/07/2019,67911,40596,17724,48080,34376,13704
15/07/2019,81053,54882,20301,68708,50847,17861
16/07/2019,84569,57803,21157,72623,53748,18875
17/07/2019,69169,48121,16990,60588,45177,15411
18/07/2019,61067,43357,14274,53816,40711,13105
19/07/2019,75054,50707,18317,62330,46334,15996
20/07/2019,50576,31260,12874,37233,26807,10426
21/07/2019,48198,30187,12389,36263,26278,9985
22/07/2019,52376,36800,12365,45607,34433,11174
23/07/2019,66278,46861,15604,58293,44052,14241
24/07/2019,87644,59589,21969,74867,55347,19520
25/07/2019,86449,58766,21301,73400,54472,18928
26/07/2019,82881,55532,20232,68183,50663,17520
27/07/2019,72256,42306,19192,49829,35279,14550
28/07/2019,67672,40209,18263,47661,33858,13803
29/07/2019,78766,53733,19502,67071,49801,17270
30/07/2019,80742,55473,19994,69571,51667,17904
31/07/2019,65580,46235,15461,57663,43430,14233
01/08/2019,87706,60806,21350,75514,56513,19001
02/08/2019,82260,55561,20170,68314,50799,17515
03/08/2019,77285,44500,20871,52003,36420,15583
04/08/2019,66868,39644,17700,46355,33018,13337
05/08/2019,82393,55448,20241,68428,50970,17458
06/08/2019,82515,56373,20494,70310,52154,18156
07/08/2019,52193,37021,12078,45505,34621,10884
08/08/2019,79609,54813,19115,67545,50743,16802
09/08/2019,80280,54040,19509,66040,49211,16829
10/08/2019,82793,46386,22668,53661,37493,16168
11/08/2019,73365,42706,19438,49586,35261,14325
12/08/2019,81371,54453,20232,67449,49927,17522
13/08/2019,75004,51952,18118,64702,48386,16316
14/08/2019,75603,52354,18240,65007,48740,16267
15/08/2019,84883,57828,20710,71507,53189,18318
16/08/2019,81541,54305,19838,66366,49258,17108
17/08/2019,78121,44138,21283,51106,35656,15450
18/08/2019,56347,33490,14893,39936,28337,11599
19/08/2019,73963,50540,18049,62631,46664,15967
20/08/2019,82301,55861,20774,69919,51547,18372
21/08/2019,73026,50360,17653,62636,46755,15881
22/08/2019,73740,50413,17899,63101,47041,16060
23/08/2019,63765,43153,15252,52684,39373,13311
24/08/2019,74220,43309,19914,50486,35811,14675
25/08/2019,71900,42030,19420,48998,34589,14409
26/08/2019,79027,53298,19666,66165,48931,17234
27/08/2019,82744,56457,20428,70659,52392,18267
28/08/2019,65082,45781,15590,57332,42994,14338
29/08/2019,83267,56490,20678,69930,51830,18100
30/08/2019,76815,50450,19267,61271,44997,16274
31/08/2019,64237,36312,16893,41207,28981,12226
01/09/2019,62667,34265,16550,38166,26736,11430
02/09/2019,37792,24140,9502,28682,20975,7707
03/09/2019,83716,57005,20884,71470,53020,18450
04/09/2019,84833,58718,21023,74206,55138,19068
05/09/2019,89656,61966,21868,77438,57685,19753
06/09/2019,55227,39526,12688,48912,37141,11771
07/09/2019,78220,46512,21265,55912,39332,16580
08/09/2019,72515,43509,19945,52587,37122,15465
09/09/2019,84809,58011,21270,72970,53902,19068
10/09/2019,87584,60095,21814,76038,56244,19794
11/09/2019,90448,61895,22914,78179,57624,20555
12/09/2019,70159,49601,16837,62067,46640,15427
13/09/2019,87636,60513,21214,73993,55422,18571
14/09/2019,75457,45664,20432,54722,38662,16060
15/09/2019,78968,46782,21549,56099,39533,16566
16/09/2019,82106,56355,20221,70232,52152,18080
17/09/2019,93117,63907,23648,80516,59284,21232
18/09/2019,90306,62364,22632,78289,57921,20368
19/09/2019,89655,61578,22351,77479,57271,20208
20/09/2019,90534,61127,22739,75519,55698,19821
21/09/2019,98755,58414,30015,57819,40639,17180
22/09/2019,76422,45280,21054,53244,37487,15757
23/09/2019,85489,58720,21448,73355,54289,19066
24/09/2019,93044,64033,23542,80516,59307,21209
25/09/2019,94015,64458,24020,81435,59854,21581
26/09/2019,84593,59103,20674,73450,54751,18699
27/09/2019,93268,63215,22894,77218,57395,19823
28/09/2019,81603,48720,22132,57020,40337,16683
29/09/2019,75753,44397,20840,52517,36763,15754
30/09/2019,76553,52183,18894,64946,48199,16747
01/10/2019,87033,59673,21894,75061,55466,19595
02/10/2019,79821,55255,19734,69536,51684,17852
03/10/2019,39067,28944,8431,35567,27592,7975
04/10/2019,83360,57425,20505,71087,52878,18209
05/10/2019,69131,41997,18578,50647,35866,14781
06/10/2019,60532,37283,16101,45289,32297,12992
07/10/2019,77323,53593,19054,67488,50182,17306
08/10/2019,80569,56581,19592,71291,53249,18042
09/10/2019,50407,36975,11586,46277,35317,10960
10/10/2019,84856,59317,20440,74340,55627,18713
11/10/2019,79369,55226,18938,68185,51130,17055
12/10/2019,70751,42613,18393,49424,35440,13984
13/10/2019,67616,39640,17650,46097,33072,13025
14/10/2019,77630,51055,19319,62245,46001,16244
15/10/2019,83345,57663,20605,72525,53916,18609
16/10/2019,44056,31466,10548,39729,29853,9876
17/10/2019,67322,48838,15176,60250,46101,14149
18/10/2019,73589,51677,17208,63520,47971,15549
19/10/2019,66879,40875,17810,48723,34691,14032
20/10/2019,28551,18918,7073,22836,16798,6038
21/10/2019,78441,53915,19231,67567,50342,17225
22/10/2019,54806,39272,13100,49860,37499,12361
23/10/2019,80480,56230,19651,70835,52854,17981
24/10/2019,83431,57722,20247,72112,53881,18231
25/10/2019,81152,55967,19523,69123,51688,17435
26/10/2019,68073,41628,18328,49733,35274,14459
27/10/2019,26758,18622,6187,22397,16905,5492
28/10/2019,76742,53167,18690,67072,49934,17138
29/10/2019,53188,38714,12252,48602,37012,11590
30/10/2019,68639,49416,16040,61913,46940,14973
31/10/2019,49656,36267,11015,44837,34406,10431
01/11/2019,70641,49343,16455,60663,45782,14881
02/11/2019,58579,36768,15267,44143,31783,12360
03/11/2019,52253,33389,13658,40547,29304,11243
04/11/2019,70117,49158,16835,61521,46133,15388
05/11/2019,73768,52489,17588,65992,49653,16339
06/11/2019,72714,51436,17537,65150,48885,16265
07/11/2019,56782,40648,13316,51088,38655,12433
08/11/2019,50295,36454,11588,45748,34867,10881
09/11/2019,37993,25381,9641,31754,23179,8575
10/11/2019,42121,27409,11060,34133,24688,9445
11/11/2019,64883,45295,15707,57003,42752,14251
12/11/2019,39188,29311,8523,36539,28348,8191
13/11/2019,43945,32558,9849,41161,31645,9516
14/11/2019,54642,40011,12479,50371,38443,11928
15/11/2019,59521,42793,13745,53308,40470,12838
16/11/2019,36896,24829,9248,31041,22766,8275
17/11/2019,32100,22000,8005,27777,20554,7223
18/11/2019,35621,26540,7948,33363,25726,7637
19/11/2019,57419,42202,13197,53313,40681,12632
20/11/2019,57625,42293,13220,53419,40753,12666
21/11/2019,62696,45547,14417,57005,43452,13553
22/11/2019,51063,37445,11495,46717,35811,10906
23/11/2019,40088,26911,10133,33336,24391,8945
24/11/2019,18146,13424,3983,16504,12752,3752
25/11/2019,58709,42603,13565,53586,40729,12857
26/11/2019,63638,45639,14854,57151,43252,13899
27/11/2019,51356,36516,12017,45569,34420,11149
28/11/2019,16173,10572,3860,12907,9490,3417
29/11/2019,23219,16021,5438,19715,14840,4875
30/11/2019,26517,17520,6560,21680,15949,5731
01/12/2019,10759,7830,2421,9714,7402,2312
02/12/2019,18018,13987,3498,17088,13663,3425
03/12/2019,39230,29656,8388,37088,28911,8177
04/12/2019,47384,35418,10501,44512,34329,10183
05/12/2019,49027,36506,10919,46052,35498,10554
06/12/2019,51607,38120,11560,47612,36588,11024
07/12/2019,34510,23945,8442,29982,22229,7753
08/12/2019,32308,22144,8064,28146,20734,7412
09/12/2019,15221,11543,3167,14149,11094,3055
10/12/2019,42435,31713,9384,39880,30805,9075
11/12/2019,38180,28783,8134,35884,28000,7884
12/12/2019,45360,34087,9878,42497,32983,9514
13/12/2019,32961,24455,7386,30550,23472,7078
14/12/2019,30263,21346,7258,26443,19749,6694
15/12/2019,33886,23613,8312,29425,21937,7488
16/12/2019,41717,31312,9104,39043,30317,8726
17/12/2019,19303,14971,3796,18180,14504,3676
18/12/2019,37898,28892,7929,35812,28117,7695
19/12/2019,29451,23015,5627,27945,22457,5488
20/12/2019,34209,26070,7043,32133,25314,6819
21/12/2019,24247,17337,5744,21934,16536,5398
22/12/2019,23726,16359,5919,20805,15382,5423
23/12/2019,37364,27214,8054,33294,25768,7526
24/12/2019,25894,18432,5976,22882,17405,5477
25/12/2019,13082,8044,2964,9212,6844,2368
26/12/2019,25226,18030,5384,21704,16806,4898
27/12/2019,31808,22371,6926,26793,20644,6149
28/12/2019,28520,18101,6979,21592,15842,5750
29/12/2019,17968,11463,4475,14246,10376,3870
30/12/2019,12138,9283,2376,11187,8906,2281
31/12/2019,31510,21844,7288,26610,20093,6517
01/01/2020,18114,12168,4184,14690,11047,3643
02/01/2020,41556,29933,9102,36614,28245,8369
03/01/2020,31873,23685,6744,28885,22533,6352
04/01/2020,29436,20567,7052,25583,19112,6471
05/01/2020,27589,19346,6684,24307,18149,6158
06/01/2020,42738,32045,9316,40113,31102,9011
07/01/2020,46535,34764,10221,43543,33716,9827
08/01/2020,42400,32126,9016,39996,31228,8768
09/01/2020,39344,29798,8347,37115,29000,8115
10/01/2020,50800,37644,11022,46474,35990,10484
11/01/2020,56538,36424,14693,44254,31981,12273
12/01/2020,53121,33462,14071,40791,29347,11444
13/01/2020,49438,36386,11157,45575,34929,10646
14/01/2020,44144,32931,9759,41299,31854,9445
15/01/2020,54251,39718,12404,49991,38181,11810
16/01/2020,45247,33933,9761,42325,32906,9419
17/01/2020,34122,26038,6964,32013,25249,6764
18/01/2020,13301,9789,2936,12139,9313,2826
19/01/2020,25935,17977,6359,22712,16805,5907
20/01/2020,24230,17667,5583,22309,17005,5304
21/01/2020,37399,28405,7879,35351,27679,7672
22/01/2020,43415,32637,9413,40818,31667,9151
23/01/2020,48258,36276,10370,45122,35074,10048
24/01/2020,51334,37794,11279,46944,36229,10715
25/01/2020,17734,12927,3836,15905,12248,3657
26/01/2020,36121,24427,9172,30848,22604,8244
27/01/2020,46534,34691,10257,43595,33687,9908
28/01/2020,48816,36473,10694,45690,35355,10335
29/01/2020,47386,35316,10476,44426,34291,10135
30/01/2020,45603,34087,9980,42638,33012,9626
31/01/2020,47284,35088,10375,43788,33857,9931
01/02/2020,35542,24523,8754,30825,22829,7996
02/02/2020,28593,19653,7032,24792,18316,6476
03/02/2020,53522,38577,12523,48840,37046,11794
04/02/2020,52478,38426,11910,48424,37020,11404
05/02/2020,50544,37651,11138,47220,36446,10774
06/02/2020,32156,24335,6852,30339,23663,6676
07/02/2020,32643,25000,6486,30391,24097,6294
08/02/2020,32783,22757,7828,28300,21119,7181
09/02/2020,32635,22172,8129,27936,20574,7362
10/02/2020,26732,20119,5689,25081,19570,5511
11/02/2020,37789,28264,8191,35445,27466,7979
12/02/2020,49336,36518,10943,45980,35427,10553
13/02/2020,37413,28366,7908,35327,27620,7707
14/02/2020,36921,27937,7703,34526,27101,7425
15/02/2020,21598,15301,5087,18984,14282,4702
16/02/2020,27276,18789,6428,22947,17264,5683
17/02/2020,40946,27921,9903,34426,25694,8732
18/02/2020,44104,32956,9444,40995,31941,9054
19/02/2020,49313,36487,10694,45424,35231,10193
20/02/2020,42686,32054,9079,39767,31004,8763
21/02/2020,38686,29006,8007,35628,27927,7701
22/02/2020,39443,26589,9354,32341,24151,8190
23/02/2020,46544,29681,11925,36302,26490,9812
24/02/2020,56349,40675,12645,50699,38830,11869
25/02/2020,39568,29541,8640,37032,28641,8391
26/02/2020,45207,33984,9631,42252,32948,9304
27/02/2020,43411,32750,9073,40628,31849,8779
28/02/2020,43360,32490,9047,39944,31297,8647
29/02/2020,29252,20554,7034,25795,19239,6556
01/03/2020,31878,21935,7713,27239,20324,6915
02/03/2020,56946,41280,12905,51394,39349,12045
03/03/2020,49723,36839,10995,45970,35492,10478
04/03/2020,58670,42609,13288,53240,40757,12483
05/03/2020,58686,42388,13312,53053,40481,12572
06/03/2020,34135,25314,7335,31353,24311,7042
07/03/2020,39448,26051,9858,32311,23613,8698
08/03/2020,46994,29255,12561,35855,25760,10095
09/03/2020,68768,46638,17015,57847,43036,14811
10/03/2020,64277,45023,15693,56655,42306,14349
11/03/2020,61816,43279,15145,54328,40505,13823
12/03/2020,51332,36242,12426,45635,34149,11486
13/03/2020,43343,29234,10676,36139,26770,9369
14/03/2020,44239,26157,12303,32168,22580,9588
15/03/2020,36140,21948,9799,27040,19234,7806
16/03/2020,29481,20432,7164,25485,19001,6484
17/03/2020,24331,16656,5891,20484,15316,5168
18/03/2020,30496,19716,8157,24946,17985,6961
19/03/2020,20842,14101,5039,17269,12881,4388
20/03/2020,31327,19953,8109,24471,17844,6627
21/03/2020,31712,18262,9082,22160,15362,6798
22/03/2020,19891,12160,5532,15027,10648,4379
23/03/2020,3999,2986,799,3571,2836,735
24/03/2020,20863,13426,5336,16554,12133,4421
25/03/2020,12066,8350,2844,10272,7741,2531
26/03/2020,21996,13901,5791,17231,12481,4750
27/03/2020,26504,16144,7145,19836,14220,5616
28/03/2020,8871,5935,2182,7266,5359,1907
29/03/2020,9646,6621,2175,7802,5935,1867
30/03/2020,15041,10138,3706,12406,9208,3198
31/03/2020,14996,10006,3886,12537,9142,3395
01/04/2020,20363,12984,5513,16231,11554,4677
02/04/2020,19012,12076,5098,15066,10751,4315
03/04/2020,11309,7850,2603,9393,7071,2322
04/04/2020,28867,16910,8031,20133,14083,6050
05/04/2020,25755,14640,7463,17701,12163,5538
06/04/2020,24660,14844,7029,18388,12772,5616
07/04/2020,23646,14549,6653,18158,12744,5414
08/04/2020,20744,13153,5665,16538,11776,4762
09/04/2020,14192,9457,3632,11744,8538,3206
10/04/2020,16276,10759,4213,13216,9559,3657
11/04/2020,33142,18657,9904,22498,15163,7335
12/04/2020,31564,17227,9090,20567,14016,6551
13/04/2020,7797,5144,1720,6160,4631,1529
14/04/2020,25283,15419,6867,19270,13554,5716
15/04/2020,22188,13841,6231,17564,12316,5248
16/04/2020,19570,12376,5591,15740,11014,4726
17/04/2020,18893,12103,5180,15275,10863,4412
18/04/2020,15909,10102,4289,12393,8815,3578
19/04/2020,47049,24578,14365,28793,19186,9607
20/04/2020,21882,13613,6051,17359,12159,5200
21/04/2020,17050,11078,4591,13993,9984,4009
22/04/2020,23783,14863,6706,18729,13152,5577
23/04/2020,19125,12372,5151,15405,10962,4443
24/04/2020,12610,8722,3089,10615,7906,2709
25/04/2020,58898,30865,18215,35995,23833,12162
26/04/2020,9586,6174,2501,7588,5428,2160
27/04/2020,17795,11780,4663,14734,10655,4079
28/04/2020,39619,22762,11930,28418,19274,9144
29/04/2020,21653,13911,6078,17675,12414,5261
30/04/2020,14542,9815,3700,12169,8923,3246
01/05/2020,24945,15902,6744,19758,14051,5707
02/05/2020,72808,37039,22658,41887,27492,14395
03/05/2020,63731,31746,20052,36531,23827,12704
04/05/2020,32356,18894,9760,23931,16141,7790
05/05/2020,35078,20449,10595,26161,17793,8368
06/05/2020,17274,11245,4684,14149,10052,4097
07/05/2020,43677,24921,13491,31456,21029,10427
08/05/2020,17326,11285,4625,14062,10055,4007
09/05/2020,27747,16359,8228,20223,13823,6400
10/05/2020,54504,28560,17279,34138,22345,11793
11/05/2020,22729,14406,6347,18167,12820,5347
12/05/2020,35998,21214,11124,27143,18229,8914
13/05/2020,40592,23331,12616,29671,19825,9846
14/05/2020,41586,23877,12918,30328,20259,10069
15/05/2020,52903,29387,15915,35909,24193,11716
16/05/2020,80292,40028,25774,45419,29340,16079
17/05/2020,63553,32314,20270,37776,24556,13220
18/05/2020,39154,22901,12080,29373,19781,9592
19/05/2020,40934,24034,12453,30236,20478,9758
20/05/2020,45558,26077,14181,33398,22231,11167
21/05/2020,48560,27494,15073,34564,23070,11494
22/05/2020,47441,26824,14563,33137,22176,10961
23/05/2020,23012,14306,6230,17210,12182,5028
24/05/2020,72889,36353,23479,41530,26583,14947
25/05/2020,67876,34057,22152,40272,25658,14614
26/05/2020,53062,29700,16675,37001,24566,12435
27/05/2020,55071,30923,17318,38856,25745,13111
28/05/2020,46091,26706,14332,34369,22885,11484
29/05/2020,53356,30752,16086,38294,25764,12530
30/05/2020,87081,44459,27477,51579,33441,18138
31/05/2020,80706,41550,25401,48208,31378,16830
01/06/2020,52926,30360,15778,37292,25066,12226
02/06/2020,46471,26450,14131,33307,22243,11064
03/06/2020,28766,16950,8965,22288,14832,7456
04/06/2020,39659,22584,12717,29140,19151,9989
05/06/2020,33064,19714,10221,25637,17214,8423
06/06/2020,56263,29156,18451,35429,22643,12786
07/06/2020,80441,41115,26201,49268,31489,17779
08/06/2020,60847,34606,18951,43211,28682,14529
09/06/2020,61666,34907,18999,43135,28835,14300
10/06/2020,63108,35389,19603,44081,29309,14772
11/06/2020,43845,26557,12969,33397,22763,10634
12/06/2020,72497,40000,22502,49090,32638,16452
13/06/2020,89690,44623,29089,52017,33330,18687
14/06/2020,79731,39758,25806,46942,30292,16650
15/06/2020,57555,32870,17819,41279,27628,13651
16/06/2020,65295,37284,20267,46249,30846,15403
17/06/2020,63989,36339,20054,45690,30307,15383
18/06/2020,62094,35355,19342,44353,29541,14812
19/06/2020,79280,42775,25339,52478,34321,18157
20/06/2020,80792,41849,25519,48678,31688,16990
21/06/2020,72206,37360,22899,43658,28387,15271
22/06/2020,59788,34892,18196,43172,29154,14018
23/06/2020,67299,38943,20743,47957,32192,15765
24/06/2020,66784,38672,20512,47921,32197,15724
25/06/2020,69578,40117,21351,49573,33284,16289
26/06/2020,73638,41595,22264,51000,34128,16872
27/06/2020,59221,32689,17908,39569,26356,13213
28/06/2020,69104,37179,21715,44295,29017,15278
29/06/2020,61574,36018,18578,44921,30355,14566
30/06/2020,65102,38515,19472,48297,32790,15507
01/07/2020,63406,37611,18782,46954,31941,15013
02/07/2020,73394,42178,22063,51696,34809,16887
03/07/2020,59329,32796,18432,40819,26792,14027
04/07/2020,70988,36998,22133,42714,27845,14869
05/07/2020,64523,34659,19755,40613,26836,13777
06/07/2020,45976,27916,13224,34709,23957,10752
07/07/2020,67810,40193,20342,50471,34171,16300
08/07/2020,63321,37589,19014,47736,32356,15380
09/07/2020,76374,44422,23015,55380,37308,18072
10/07/2020,22777,14726,6034,18115,12901,5214
11/07/2020,66573,36936,20620,45771,30115,15656
12/07/2020,84290,44135,26847,53349,34404,18945
13/07/2020,69017,40075,21093,50882,34094,16788
14/07/2020,76968,44671,23568,56410,37877,18533
15/07/2020,78340,45167,24319,57348,38235,19113
16/07/2020,79248,45614,24275,57482,38433,19049
17/07/2020,69834,40271,20651,51161,34436,16725
18/07/2020,80408,41880,24462,52047,33894,18153
19/07/2020,66789,35770,20486,43810,28841,14969
20/07/2020,58285,34577,17243,44409,30331,14078
21/07/2020,70557,41684,21190,53326,36217,17109
22/07/2020,51988,31476,15358,40579,27740,12839
23/07/2020,65592,38820,19327,50818,34511,16307
24/07/2020,66790,39118,19294,49664,33832,15832
25/07/2020,87636,45609,26753,55783,36352,19431
26/07/2020,72734,38861,21960,47714,31469,16245
27/07/2020,62474,37013,18395,47298,32197,15101
28/07/2020,70368,41435,20667,52535,35673,16862
29/07/2020,77064,44766,22810,56619,38277,18342
30/07/2020,72109,42410,20772,54547,37247,17300
31/07/2020,70846,40489,20493,51655,34883,16772
01/08/2020,89044,47389,27413,56079,36841,19238
02/08/2020,70067,38475,21043,46235,30861,15374
03/08/2020,67219,39890,19944,50125,33996,16129
04/08/2020,44588,27864,12314,34423,24212,10211
05/08/2020,81812,47930,24408,59659,40507,19152
06/08/2020,79130,46299,23677,57848,39170,18678
07/08/2020,59956,35677,16925,43925,30386,13539
08/08/2020,90237,48294,27423,56898,37544,19354
09/08/2020,82767,43974,25410,52247,34322,17925
10/08/2020,68992,40653,20615,51223,34714,16509
11/08/2020,75292,44146,22197,55008,37463,17545
12/08/2020,66069,39717,19146,49999,34271,15728
13/08/2020,62427,37954,17701,47204,32673,14531
14/08/2020,83758,47940,24664,59208,40035,19173
15/08/2020,92784,49162,28300,57519,37752,19767
16/08/2020,38651,22957,10093,26624,18765,7859
17/08/2020,70358,41717,20787,52167,35577,16590
18/08/2020,81799,47362,24294,59365,40285,19080
19/08/2020,71467,42270,20830,53366,36454,16912
20/08/2020,81247,45813,23860,57642,38736,18906
21/08/2020,84814,48185,25402,60004,40236,19768
22/08/2020,87086,46080,26549,54438,35682,18756
23/08/2020,81801,43519,25270,52363,34286,18077
24/08/2020,71136,41943,21089,53152,36021,17131
25/08/2020,72067,43009,20795,54325,37253,17072
26/08/2020,88080,51197,26590,65348,43802,21546
27/08/2020,69313,41715,20066,52698,36161,16537
28/08/2020,78167,45979,22618,56982,38834,18148
29/08/2020,71287,39945,20749,48267,32346,15921
30/08/2020,92434,48840,28372,58416,38189,20227
31/08/2020,75665,44877,22258,57009,38727,18282
01/09/2020,76674,45339,22697,57816,39209,18607
02/09/2020,69998,42092,20163,53383,36605,16778
03/09/2020,71317,42424,21143,54352,36820,17532
04/09/2020,85339,48590,25656,60802,40617,20185
05/09/2020,89572,47022,28177,55357,35898,19459
06/09/2020,83006,43151,25833,48900,31907,16993
07/09/2020,83897,44952,26275,52438,34477,17961
08/09/2020,79236,47245,23585,59795,40638,19157
09/09/2020,84416,50097,25336,64528,43529,20999
10/09/2020,52907,32927,14694,41385,29001,12384
11/09/2020,94644,55323,28253,69019,46588,22431
12/09/2020,101462,54312,31654,64661,42298,22363
13/09/2020,84682,45930,26228,55738,36682,19056
14/09/2020,79263,47537,23585,60477,41193,19284
15/09/2020,84118,50580,25189,64470,43795,20675
16/09/2020,86977,52136,25551,66586,45243,21343
17/09/2020,87490,52495,25670,66525,45443,21082
18/09/2020,89018,52467,26229,65618,44382,21236
19/09/2020,89985,48400,27989,57345,37555,19790
20/09/2020,77666,41928,24078,50699,33310,17389
21/09/2020,72111,43929,20990,55560,38088,17472
22/09/2020,82861,49953,24636,63631,43208,20423
23/09/2020,90600,53933,27032,68520,46379,22141
24/09/2020,86938,51845,25786,65824,44600,21224
25/09/2020,93712,54819,27561,67887,45844,22043
26/09/2020,99262,53538,30406,62264,40864,21400
27/09/2020,87411,47075,27225,56384,36865,19519
28/09/2020,78056,46586,22937,58606,39867,18739
29/09/2020,59816,37579,16922,48016,33396,14620
30/09/2020,85791,51845,24963,65609,44887,20722
01/10/2020,89718,53881,26270,68436,46542,21894
02/10/2020,81001,48661,22990,60188,41378,18810
03/10/2020,95562,51526,29011,61065,40120,20945
04/10/2020,80662,43251,25169,52836,34482,18354
05/10/2020,75795,45784,22024,58037,39622,18415
06/10/2020,85634,51458,25048,65821,44816,21005
07/10/2020,81263,49272,23337,62687,43103,19584
08/10/2020,83990,50574,24214,64407,44121,20286
09/10/2020,87644,51830,25674,64879,43977,20902
10/10/2020,93919,50774,28364,59472,39302,20170
11/10/2020,75426,41611,22733,49746,33169,16577
12/10/2020,16405,11376,3676,13522,10213,3309
13/10/2020,51885,33463,13976,42348,29906,12442
14/10/2020,88404,53189,26222,68674,46578,22096
15/10/2020,91295,55185,26797,69943,47730,22213
16/10/2020,30689,20435,7713,25032,18155,6877
17/10/2020,88338,48381,27180,58909,38696,20213
18/10/2020,76910,42290,23848,52204,34332,17872
19/10/2020,73336,44925,21472,57872,39645,18227
20/10/2020,76195,46754,22156,60147,41197,18950
21/10/2020,84145,51424,24510,65938,45185,20753
22/10/2020,83848,51157,24484,65407,44744,20663
23/10/2020,86939,52615,24571,65473,45130,20343
24/10/2020,90596,50476,26789,60310,40181,20129
25/10/2020,61869,35336,18522,43554,29151,14403
26/10/2020,51135,33395,13730,42077,29916,12161
27/10/2020,78030,48558,22521,62592,43199,19393
28/10/2020,62847,39678,17446,50413,35156,15257
29/10/2020,19072,13001,4476,15951,11804,4147
30/10/2020,39546,26002,10080,32065,23204,8861
31/10/2020,66771,38914,19835,48511,32559,15952
01/11/2020,32600,20316,8776,24983,17594,7389
02/11/2020,50610,33191,13729,42617,30237,12380
03/11/2020,62112,39296,17560,50717,35342,15375
04/11/2020,65204,40467,18986,52695,36067,16628
05/11/2020,74725,46121,21717,59448,40708,18740
06/11/2020,82142,49685,23759,62797,42887,19910
07/11/2020,98467,53712,29597,64014,42402,21612
08/11/2020,86147,46483,26543,56434,37179,19255
09/11/2020,75799,45968,22631,59311,40238,19073
10/11/2020,84365,51036,25004,65969,44883,21086
11/11/2020,46257,29395,13004,37597,26209,11388
12/11/2020,40704,26855,10525,33635,24226,9409
13/11/2020,48657,31622,12601,39011,28037,10974
14/11/2020,75263,42608,22551,52421,34926,17495
15/11/2020,51003,30005,15093,37721,25503,12218
16/11/2020,57607,36638,16293,47336,33054,14282
17/11/2020,54480,35250,15247,45760,32074,13686
18/11/2020,44054,28892,12122,37907,26758,11149
19/11/2020,51425,33259,14163,43268,30460,12808
20/11/2020,68483,42088,19573,53998,37186,16812
21/11/2020,75233,42488,22428,52338,34928,17410
22/11/2020,46012,27160,13436,34612,23434,11178
23/11/2020,42599,27763,11481,35522,25247,10275
24/11/2020,53102,33991,14814,44020,30783,13237
25/11/2020,56843,35996,15696,45978,32122,13856
26/11/2020,30687,18479,8115,22143,15509,6634
27/11/2020,53108,31414,14915,38065,26096,11969
28/11/2020,53202,31014,15523,37987,25634,12353
29/11/2020,52557,30502,15631,38480,25908,12572
30/11/2020,23257,16161,5486,19894,14838,5056
01/12/2020,53067,34398,14646,44641,31444,13197
02/12/2020,47330,31020,12732,40345,28723,11622
03/12/2020,53146,34069,14619,44372,31215,13157
04/12/2020,40441,26453,10687,33877,24153,9724
05/12/2020,31809,20132,8323,25018,17733,7285
06/12/2020,40743,24498,11737,31739,21693,10046
07/12/2020,41591,27472,11313,35970,25518,10452
08/12/2020,41083,27420,11089,35834,25586,10248
09/12/2020,37053,24832,9828,32462,23261,9201
10/12/2020,51890,33896,14104,43878,31080,12798
11/12/2020,59906,37958,16508,48570,33949,14621
12/12/2020,53499,32278,14804,40249,27848,12401
13/12/2020,61081,35111,17984,44446,29953,14493
14/12/2020,25786,17598,6429,22366,16397,5969
15/12/2020,44793,29349,12389,38682,27336,11346
16/12/2020,26329,17736,7012,23326,16759,6567
17/12/2020,179,138,23,140,120,20
18/12/2020,14964,10744,3227,13030,10026,3004
19/12/2020,16738,11421,3941,13996,10414,3582
20/12/2020,16340,11131,3858,13780,10238,3542
21/12/2020,31415,21517,7685,27306,20139,7167
22/12/2020,37256,25218,9400,32112,23426,8686
23/12/2020,40454,26655,10532,34374,24661,9713
24/12/2020,32606,21317,8166,27014,19530,7484
25/12/2020,11850,7528,2856,9107,6624,2483
26/12/2020,19791,12804,5086,15987,11466,4521
27/12/2020,23764,14640,6550,18826,13125,5701
28/12/2020,38784,24509,10349,31425,22236,9189
29/12/2020,33202,21668,8624,27902,20021,7881
30/12/2020,35705,23208,9441,30097,21454,8643
31/12/2020,26334,17057,6674,21623,15567,6056
01/01/2021,18790,11401,5034,14533,10174,4359
02/01/2021,41195,24079,11694,31192,21311,9881
03/01/2021,14578,9664,3458,12060,8912,3148
04/01/2021,36745,24391,9549,31637,22818,8819
05/01/2021,38525,25498,10191,33352,23924,9428
06/01/2021,37929,25054,10186,32934,23492,9442
07/01/2021,37971,25341,10031,33020,23748,9272
08/01/2021,37138,24562,9793,32000,22924,9076
09/01/2021,34643,21571,9721,28248,19623,8625
10/01/2021,35366,21647,10028,28460,19644,8816
11/01/2021,36106,24225,9470,31844,22947,8897
12/01/2021,42298,28126,11296,36889,26445,10444
13/01/2021,42522,28328,11126,36908,26566,10342
14/01/2021,47832,31389,12735,40886,29222,11664
15/01/2021,40508,26716,10598,34648,24848,9800
16/01/2021,41189,25163,11365,32112,22410,9702
17/01/2021,38831,23079,11041,29637,20315,9322
18/01/2021,42740,26800,11674,34634,24373,10261
19/01/2021,40592,26969,10748,35252,25205,10047
20/01/2021,36251,24478,9350,31733,22945,8788
21/01/2021,40897,27203,10720,35340,25390,9950
22/01/2021,44037,28840,11679,37327,26613,10714
23/01/2021,32137,20552,8433,26174,18706,7468
24/01/2021,27353,17730,7014,22507,16184,6323
25/01/2021,36060,24279,9373,31474,22737,8737
26/01/2021,27375,18972,6686,24377,17982,6395
27/01/2021,38982,26277,10134,34260,24742,9518
28/01/2021,34137,23178,8874,30296,21951,8345
29/01/2021,23566,16602,5525,20916,15681,5235
30/01/2021,27330,17908,6895,22650,16410,6240
31/01/2021,21723,14587,5429,18575,13577,4998
01/02/2021,249,,,,,
03/02/2021,6488,,,,,
04/02/2021,18792,,,,,
05/02/2021,24378,,,,,
06/02/2021,31236,,,,,
07/02/2021,8308,,,,,
08/02/2021,18534,,,,,
09/02/2021,22482,,,,,
10/02/2021,28232,,,,,
11/02/2021,22979,,,,,
12/02/2021,26009,,,,,
13/02/2021,23084,,,,,
14/02/2021,23441,,,,,
15/02/2021,23404,,,,,
16/02/2021,31048,,,,,
17/02/2021,30902,,,,,
18/02/2021,7630,,,,,
19/02/2021,12061,,,,,
20/02/2021,24992,,,,,
21/02/2021,26475,,,,,
22/02/2021,19553,,,,,
23/02/2021,33534,,,,,
24/02/2021,46049,,,,,
25/02/2021,43427,,,,,
26/02/2021,44560,,,,,
27/02/2021,30815,,,,,
28/02/2021,21321,,,,,
01/03/2021,34575,,,,,
02/03/2021,32100,,,,,
03/03/2021,50122,,,,,
04/03/2021,40247,,,,,
05/03/2021,36338,,,,,
06/03/2021,33478,,,,,
07/03/2021,35352,,,,,
08/03/2021,38478,,,,,
09/03/2021,60231,,,,,
10/03/2021,54876,,,,,
11/03/2021,68394,,,,,
12/03/2021,69490,,,,,
13/03/2021,53517,,,,,
14/03/2021,43533,,,,,
15/03/2021,34394,,,,,
16/03/2021,38031,,,,,
17/03/2021,47314,,,,,
18/03/2021,22554,,,,,
19/03/2021,43779,,,,,
20/03/2021,65050,,,,,
21/03/2021,68873,,,,,
22/03/2021,56194,,,,,
23/03/2021,61564,,,,,
24/03/2021,32777,,,,,
25/03/2021,64657,,,,,
26/03/2021,71615,,,,,
27/03/2021,84712,,,,,
28/03/2021,25256,,,,,
29/03/2021,52598,,,,,
30/03/2021,65613,,,,,
31/03/2021,45382,,,,,
01/04/2021,45527,,,,,
02/04/2021,42831,,,,,
03/04/2021,61218,,,,,
04/04/2021,63335,,,,,
05/04/2021,68141,,,,,
06/04/2021,76225,,,,,
07/04/2021,77680,,,,,
08/04/2021,81552,,,,,
09/04/2021,68187,,,,,
10/04/2021,87596,,,,,
11/04/2021,20135,,,,,
12/04/2021,33647,,,,,
13/04/2021,78682,,,,,
14/04/2021,80113,,,,,
15/04/2021,33032,,,,,
16/04/2021,59414,,,,,
17/04/2021,77508,,,,,
18/04/2021,80652,,,,,
19/04/2021,73000,,,,,
20/04/2021,96136,,,,,
21/04/2021,61764,,,,,
22/04/2021,57101,,,,,
23/04/2021,82793,,,,,
24/04/2021,104081,,,,,
25/04/2021,58487,,,,,
26/04/2021,71658,,,,,
27/04/2021,79576,,,,,
28/04/2021,96329,,,,,
29/04/2021,70576,,,,,
30/04/2021,80693,,,,,
01/05/2021,92840,,,,,
02/05/2021,93982,,,,,
03/05/2021,60831,,,,,
04/05/2021,87014,,,,,
05/05/2021,49749,,,,,
06/05/2021,93267,,,,,
07/05/2021,91204,,,,,
08/05/2021,59759,,,,,
09/05/2021,53317,,,,,
10/05/2021,71172,,,,,
11/05/2021,89079,,,,,
12/05/2021,94864,,,,,
13/05/2021,100737,,,,,
14/05/2021,107380,,,,,
15/05/2021,118947,,,,,
16/05/2021,97138,,,,,
17/05/2021,95272,,,,,
18/05/2021,105861,,,,,
19/05/2021,109860,,,,,
20/05/2021,108242,,,,,
21/05/2021,112908,,,,,
22/05/2021,116548,,,,,
23/05/2021,107595,,,,,
24/05/2021,89255,,,,,
25/05/2021,107021,,,,,
26/05/2021,97890,,,,,
27/05/2021,112627,,,,,
28/05/2021,62800,,,,,
29/05/2021,30059,,,,,
30/05/2021,17684,,,,,
31/05/2021,89263,,,,,
01/06/2021,99568,,,,,
02/06/2021,106586,,,,,
03/06/2021,70042,,,,,
04/06/2021,86676,,,,,
05/06/2021,121369,,,,,
06/06/2021,106212,,,,,
07/06/2021,98136,,,,,
08/06/2021,74849,,,,,
09/06/2021,112208,,,,,
10/06/2021,121438,,,,,
11/06/2021,108153,,,,,
12/06/2021,117012,,,,,
13/06/2021,102575,,,,,
14/06/2021,84523,,,,,
15/06/2021,119217,,,,,
16/06/2021,122265,,,,,
17/06/2021,121535,,,,,
18/06/2021,123246,,,,,
19/06/2021,107542,,,,,
20/06/2021,107533,,,,,
21/06/2021,101975,,,,,
22/06/2021,75593,,,,,
23/06/2021,123492,,,,,
24/06/2021,120780,,,,,
25/06/2021,116688,,,,,
26/06/2021,119093,,,,,
27/06/2021,110160,,,,,
28/06/2021,98754,,,,,
29/06/2021,103426,,,,,
30/06/2021,96871,,,,,
01/07/2021,68029,,,,,
02/07/2021,78211,,,,,
03/07/2021,68499,,,,,
04/07/2021,101570,,,,,
05/07/2021,97858,,,,,
06/07/2021,77404,,,,,
07/07/2021,102953,,,,,
08/07/2021,74952,,,,,
09/07/2021,86377,,,,,
10/07/2021,109400,,,,,
11/07/2021,103479,,,,,
12/07/2021,87989,,,,,
13/07/2021,105508,,,,,
14/07/2021,110453,,,,,
15/07/2021,112482,,,,,
16/07/2021,108273,,,,,
17/07/2021,82393,,,,,
18/07/2021,99910,,,,,
19/07/2021,102765,,,,,
20/07/2021,111603,,,,,
21/07/2021,108755,,,,,
22/07/2021,118482,,,,,
23/07/2021,112617,,,,,
24/07/2021,125233,,,,,
25/07/2021,98055,,,,,
26/07/2021,98830,,,,,
27/07/2021,106208,,,,,
28/07/2021,112492,,,,,
29/07/2021,76088,,,,,
30/07/2021,115766,,,,,
31/07/2021,121903,,,,,
01/08/2021,94660,,,,,
02/08/2021,103217,,,,,
03/08/2021,108958,,,,,
04/08/2021,109230,,,,,
05/08/2021,109449,,,,,
06/08/2021,109426,,,,,
07/08/2021,115257,,,,,
08/08/2021,75455,,,,,
09/08/2021,96503,,,,,
10/08/2021,92678,,,,,
11/08/2021,97923,,,,,
12/08/2021,99787,,,,,
13/08/2021,98715,,,,,
14/08/2021,111781,,,,,
15/08/2021,108602,,,,,
16/08/2021,102320,,,,,
17/08/2021,107423,,,,,
18/08/2021,106527,,,,,
19/08/2021,104846,,,,,
20/08/2021,102337,,,,,
21/08/2021,96370,,,,,
22/08/2021,15852,,,,,
23/08/2021,76853,,,,,
24/08/2021,109279,,,,,
25/08/2021,106712,,,,,
26/08/2021,103683,,,,,
27/08/2021,88698,,,,,
28/08/2021,104332,,,,,
29/08/2021,102469,,,,,
30/08/2021,101166,,,,,
31/08/2021,111970,,,,,
01/09/2021,50782,,,,,
02/09/2021,126450,,,,,
03/09/2021,115060,,,,,
04/09/2021,109096,,,,,
05/09/2021,87491,,,,,
06/09/2021,106319,,,,,
07/09/2021,106915,,,,,
08/09/2021,113132,,,,,
09/09/2021,77648,,,,,
10/09/2021,126605,,,,,
11/09/2021,133564,,,,,
12/09/2021,117208,,,,,
13/09/2021,105983,,,,,
14/09/2021,118471,,,,,
15/09/2021,118359,,,,,
16/09/2021,109630,,,,,
17/09/2021,111908,,,,,
18/09/2021,124633,,,,,
19/09/2021,116461,,,,,
20/09/2021,109092,,,,,
21/09/2021,113237,,,,,
22/09/2021,113373,,,,,
23/09/2021,86729,,,,,
24/09/2021,115890,,,,,
25/09/2021,125178,,,,,
26/09/2021,113543,,,,,
27/09/2021,106803,,,,,
28/09/2021,96552,,,,,
29/09/2021,111532,,,,,
30/09/2021,112577,,,,,
01/10/2021,115828,,,,,
02/10/2021,120155,,,,,
03/10/2021,108304,,,,,
04/10/2021,73613,,,,,
05/10/2021,103932,,,,,
06/10/2021,110685,,,,,
07/10/2021,115335,,,,,
08/10/2021,115808,,,,,
09/10/2021,108091,,,,,
10/10/2021,69386,,,,,
11/10/2021,97257,,,,,
12/10/2021,108314,,,,,
13/10/2021,109850,,,,,
14/10/2021,116278,,,,,
15/10/2021,118471,,,,,
16/10/2021,99245,,,,,
17/10/2021,90860,,,,,
18/10/2021,87314,,,,,
19/10/2021,100118,,,,,
20/10/2021,112026,,,,,
21/10/2021,113734,,,,,
22/10/2021,111573,,,,,
23/10/2021,91369,,,,,
24/10/2021,85039,,,,,
25/10/2021,92446,,,,,
26/10/2021,48015,,,,,
27/10/2021,97986,,,,,
28/10/2021,100689,,,,,
29/10/2021,82622,,,,,
30/10/2021,79170,,,,,
31/10/2021,85726,,,,,